Date,Area,Area_type,Population (P),Daily_cases,Cumulative_cases,Daily_deaths,Cumulative_deaths,Daily_tests,Cumulative_tests,Daily_positive_tests,Cumulative_positive_tests
2/1/2020 0:00,Los Angeles,County,10257557,14,14,0,0,284,284,10,10
2/2/2020 0:00,Los Angeles,County,10257557,4,18,0,0,23,307,1,11
2/3/2020 0:00,Los Angeles,County,10257557,4,22,0,0,14,321,1,12
2/4/2020 0:00,Los Angeles,County,10257557,1,23,0,0,3,324,0,12
2/5/2020 0:00,Los Angeles,County,10257557,0,23,0,0,2,326,0,12
2/6/2020 0:00,Los Angeles,County,10257557,0,23,0,0,2,328,0,12
2/7/2020 0:00,Los Angeles,County,10257557,1,24,0,0,8,336,0,12
2/8/2020 0:00,Los Angeles,County,10257557,1,25,0,0,49,385,0,12
2/9/2020 0:00,Los Angeles,County,10257557,3,28,0,0,5,390,0,12
2/10/2020 0:00,Los Angeles,County,10257557,1,29,0,0,1,391,0,12
2/11/2020 0:00,Los Angeles,County,10257557,2,31,0,0,3,394,0,12
2/12/2020 0:00,Los Angeles,County,10257557,0,31,0,0,1,395,0,12
2/13/2020 0:00,Los Angeles,County,10257557,1,32,0,0,4,399,0,12
2/14/2020 0:00,Los Angeles,County,10257557,3,35,0,0,5,404,0,12
2/15/2020 0:00,Los Angeles,County,10257557,5,40,0,0,7,411,0,12
2/16/2020 0:00,Los Angeles,County,10257557,3,43,0,0,2,413,1,13
2/17/2020 0:00,Los Angeles,County,10257557,5,48,0,0,6,419,0,13
2/18/2020 0:00,Los Angeles,County,10257557,3,51,0,0,4,423,0,13
2/19/2020 0:00,Los Angeles,County,10257557,3,54,0,0,3,426,0,13
2/20/2020 0:00,Los Angeles,County,10257557,2,56,0,0,10,436,0,13
2/21/2020 0:00,Los Angeles,County,10257557,1,57,0,0,2,438,0,13
2/22/2020 0:00,Los Angeles,County,10257557,4,61,0,0,3,441,0,13
2/23/2020 0:00,Los Angeles,County,10257557,2,63,0,0,2,443,0,13
2/24/2020 0:00,Los Angeles,County,10257557,8,71,0,0,3,446,1,14
2/25/2020 0:00,Los Angeles,County,10257557,6,77,0,0,4,450,0,14
2/26/2020 0:00,Los Angeles,County,10257557,12,89,0,0,3,453,0,14
2/27/2020 0:00,Los Angeles,County,10257557,6,95,0,0,4,457,0,14
2/28/2020 0:00,Los Angeles,County,10257557,8,103,0,0,20,477,0,14
2/29/2020 0:00,Los Angeles,County,10257557,8,111,0,0,4,481,0,14
3/1/2020 0:00,Los Angeles,County,10257557,28,139,0,0,17,498,2,16
3/2/2020 0:00,Los Angeles,County,10257557,19,158,0,0,20,518,11,27
3/3/2020 0:00,Los Angeles,County,10257557,15,173,0,0,19,537,8,35
3/4/2020 0:00,Los Angeles,County,10257557,19,192,0,0,12,549,2,37
3/5/2020 0:00,Los Angeles,County,10257557,36,228,0,0,37,586,2,39
3/6/2020 0:00,Los Angeles,County,10257557,47,275,0,0,23,609,2,41
3/7/2020 0:00,Los Angeles,County,10257557,43,318,0,0,27,636,6,47
3/8/2020 0:00,Los Angeles,County,10257557,51,369,0,0,53,689,11,58
3/9/2020 0:00,Los Angeles,County,10257557,95,464,0,0,188,877,31,89
3/10/2020 0:00,Los Angeles,County,10257557,104,568,0,0,196,1073,21,110
3/11/2020 0:00,Los Angeles,County,10257557,136,704,0,0,362,1435,32,142
3/12/2020 0:00,Los Angeles,County,10257557,173,877,0,0,836,2271,88,230
3/13/2020 0:00,Los Angeles,County,10257557,164,1041,0,0,1039,3310,100,330
3/14/2020 0:00,Los Angeles,County,10257557,157,1198,0,0,640,3950,67,397
3/15/2020 0:00,Los Angeles,County,10257557,182,1380,0,0,723,4673,71,468
3/16/2020 0:00,Los Angeles,County,10257557,248,1628,1,1,1966,6639,220,688
3/17/2020 0:00,Los Angeles,County,10257557,238,1866,0,1,2575,9214,270,958
3/18/2020 0:00,Los Angeles,County,10257557,209,2075,0,1,2271,11485,229,1187
3/19/2020 0:00,Los Angeles,County,10257557,245,2320,4,5,2565,14050,267,1454
3/20/2020 0:00,Los Angeles,County,10257557,290,2610,3,8,2843,16893,302,1756
3/21/2020 0:00,Los Angeles,County,10257557,228,2838,4,12,1445,18338,185,1941
3/22/2020 0:00,Los Angeles,County,10257557,276,3114,4,16,1206,19544,225,2166
3/23/2020 0:00,Los Angeles,County,10257557,330,3444,7,23,3731,23275,478,2644
3/24/2020 0:00,Los Angeles,County,10257557,308,3752,4,27,3732,27007,478,3122
3/25/2020 0:00,Los Angeles,County,10257557,444,4196,6,33,3507,30514,447,3569
3/26/2020 0:00,Los Angeles,County,10257557,400,4596,4,37,3516,34030,485,4054
3/27/2020 0:00,Los Angeles,County,10257557,407,5003,9,46,4044,38074,554,4608
3/28/2020 0:00,Los Angeles,County,10257557,408,5411,9,55,3214,41288,467,5075
3/29/2020 0:00,Los Angeles,County,10257557,385,5796,16,71,1631,42919,302,5377
3/30/2020 0:00,Los Angeles,County,10257557,650,6446,10,81,4741,47660,689,6066
3/31/2020 0:00,Los Angeles,County,10257557,662,7108,18,99,5094,52754,727,6793
4/1/2020 0:00,Los Angeles,County,10257557,664,7772,20,119,5634,58388,816,7609
4/2/2020 0:00,Los Angeles,County,10257557,648,8420,22,141,5661,64049,792,8401
4/3/2020 0:00,Los Angeles,County,10257557,827,9247,27,168,6124,70173,746,9147
4/4/2020 0:00,Los Angeles,County,10257557,614,9861,21,189,3511,73684,605,9752
4/5/2020 0:00,Los Angeles,County,10257557,615,10476,26,215,2206,75890,506,10258
4/6/2020 0:00,Los Angeles,County,10257557,568,11044,17,232,4078,79968,620,10878
4/7/2020 0:00,Los Angeles,County,10257557,730,11774,26,258,5139,85107,913,11791
4/8/2020 0:00,Los Angeles,County,10257557,651,12425,43,301,5988,91095,853,12644
4/9/2020 0:00,Los Angeles,County,10257557,597,13022,41,342,7602,98697,764,13408
4/10/2020 0:00,Los Angeles,County,10257557,628,13650,30,372,7801,106498,803,14211
4/11/2020 0:00,Los Angeles,County,10257557,520,14170,35,407,4073,110571,536,14747
4/12/2020 0:00,Los Angeles,County,10257557,474,14644,38,445,1890,112461,380,15127
4/13/2020 0:00,Los Angeles,County,10257557,721,15365,47,492,4952,117413,943,16070
4/14/2020 0:00,Los Angeles,County,10257557,721,16086,50,542,6584,123997,930,17000
4/15/2020 0:00,Los Angeles,County,10257557,893,16979,38,580,9563,133560,1124,18124
4/16/2020 0:00,Los Angeles,County,10257557,822,17801,62,642,9235,142795,932,19056
4/17/2020 0:00,Los Angeles,County,10257557,892,18693,44,686,9725,152520,947,20003
4/18/2020 0:00,Los Angeles,County,10257557,640,19333,43,729,6865,159385,764,20767
4/19/2020 0:00,Los Angeles,County,10257557,529,19862,41,770,4286,163671,519,21286
4/20/2020 0:00,Los Angeles,County,10257557,1007,20869,48,818,9100,172771,1204,22490
4/21/2020 0:00,Los Angeles,County,10257557,911,21780,44,862,11569,184340,1110,23600
4/22/2020 0:00,Los Angeles,County,10257557,863,22643,52,914,9325,193665,1024,24624
4/23/2020 0:00,Los Angeles,County,10257557,1026,23669,51,965,8992,202657,1147,25771
4/24/2020 0:00,Los Angeles,County,10257557,1062,24731,44,1009,12619,215276,1309,27080
4/25/2020 0:00,Los Angeles,County,10257557,930,25661,43,1052,11314,226590,1119,28199
4/26/2020 0:00,Los Angeles,County,10257557,633,26294,45,1097,5263,231853,575,28774
4/27/2020 0:00,Los Angeles,County,10257557,1155,27449,43,1140,16622,248475,1399,30173
4/28/2020 0:00,Los Angeles,County,10257557,1020,28469,58,1198,15202,263677,1298,31471
4/29/2020 0:00,Los Angeles,County,10257557,1063,29532,46,1244,15499,279176,1285,32756
4/30/2020 0:00,Los Angeles,County,10257557,977,30509,52,1296,22003,301179,1230,33986
5/1/2020 0:00,Los Angeles,County,10257557,1009,31518,42,1338,22390,323569,1196,35182
5/2/2020 0:00,Los Angeles,County,10257557,756,32274,50,1388,17009,340578,842,36024
5/3/2020 0:00,Los Angeles,County,10257557,530,32804,44,1432,7734,348312,529,36553
5/4/2020 0:00,Los Angeles,County,10257557,957,33761,48,1480,21567,369879,1029,37582
5/5/2020 0:00,Los Angeles,County,10257557,1283,35044,39,1519,23050,392929,1478,39060
5/6/2020 0:00,Los Angeles,County,10257557,1068,36112,54,1573,27105,420034,1393,40453
5/7/2020 0:00,Los Angeles,County,10257557,1001,37113,51,1624,24936,444970,1279,41732
5/8/2020 0:00,Los Angeles,County,10257557,1121,38234,51,1675,22271,467241,1336,43068
5/9/2020 0:00,Los Angeles,County,10257557,734,38968,56,1731,15179,482420,973,44041
5/10/2020 0:00,Los Angeles,County,10257557,621,39589,35,1766,6266,488686,495,44536
5/11/2020 0:00,Los Angeles,County,10257557,1259,40848,33,1799,21675,510361,1436,45972
5/12/2020 0:00,Los Angeles,County,10257557,1183,42031,50,1849,25670,536031,1563,47535
5/13/2020 0:00,Los Angeles,County,10257557,993,43024,46,1895,26083,562114,1428,48963
5/14/2020 0:00,Los Angeles,County,10257557,1312,44336,34,1929,30079,592193,1967,50930
5/15/2020 0:00,Los Angeles,County,10257557,1172,45508,47,1976,30884,623077,1843,52773
5/16/2020 0:00,Los Angeles,County,10257557,788,46296,56,2032,18943,642020,1096,53869
5/17/2020 0:00,Los Angeles,County,10257557,574,46870,45,2077,7668,649688,582,54451
5/18/2020 0:00,Los Angeles,County,10257557,1241,48111,51,2128,27921,677609,1873,56324
5/19/2020 0:00,Los Angeles,County,10257557,1026,49137,50,2178,25994,703603,1706,58030
5/20/2020 0:00,Los Angeles,County,10257557,1204,50341,32,2210,26859,730462,2100,60130
5/21/2020 0:00,Los Angeles,County,10257557,990,51331,31,2241,25346,755808,1669,61799
5/22/2020 0:00,Los Angeles,County,10257557,1040,52371,50,2291,26547,782355,1555,63354
5/23/2020 0:00,Los Angeles,County,10257557,797,53168,37,2328,17837,800192,1096,64450
5/24/2020 0:00,Los Angeles,County,10257557,545,53713,42,2370,6804,806996,523,64973
5/25/2020 0:00,Los Angeles,County,10257557,1016,54729,32,2402,7132,814128,785,65758
5/26/2020 0:00,Los Angeles,County,10257557,1813,56542,43,2445,31357,845485,2699,68457
5/27/2020 0:00,Los Angeles,County,10257557,1466,58008,54,2499,28439,873924,2018,70475
5/28/2020 0:00,Los Angeles,County,10257557,1371,59379,33,2532,26800,900724,1853,72328
5/29/2020 0:00,Los Angeles,County,10257557,1576,60955,37,2569,27487,928211,1951,74279
5/30/2020 0:00,Los Angeles,County,10257557,956,61911,40,2609,17231,945442,1232,75511
5/31/2020 0:00,Los Angeles,County,10257557,535,62446,34,2643,7015,952457,473,75984
6/1/2020 0:00,Los Angeles,County,10257557,1295,63741,44,2687,20132,972589,1376,77360
6/2/2020 0:00,Los Angeles,County,10257557,1474,65215,33,2720,22537,995126,1710,79070
6/3/2020 0:00,Los Angeles,County,10257557,1402,66617,46,2766,25021,1020147,1814,80884
6/4/2020 0:00,Los Angeles,County,10257557,1599,68216,48,2814,26325,1046472,1778,82662
6/5/2020 0:00,Los Angeles,County,10257557,1465,69681,41,2855,30173,1076645,1854,84516
6/6/2020 0:00,Los Angeles,County,10257557,1151,70832,38,2893,21853,1098498,1405,85921
6/7/2020 0:00,Los Angeles,County,10257557,755,71587,38,2931,8039,1106537,577,86498
6/8/2020 0:00,Los Angeles,County,10257557,1711,73298,39,2970,29990,1136527,2125,88623
6/9/2020 0:00,Los Angeles,County,10257557,1460,74758,42,3012,32732,1169259,1886,90509
6/10/2020 0:00,Los Angeles,County,10257557,1657,76415,27,3039,31086,1200345,2209,92718
6/11/2020 0:00,Los Angeles,County,10257557,1515,77930,27,3066,29578,1229923,2126,94844
6/12/2020 0:00,Los Angeles,County,10257557,1666,79596,33,3099,30646,1260569,1938,96782
6/13/2020 0:00,Los Angeles,County,10257557,1406,81002,32,3131,18255,1278824,1544,98326
6/14/2020 0:00,Los Angeles,County,10257557,1041,82043,30,3161,8589,1287413,754,99080
6/15/2020 0:00,Los Angeles,County,10257557,2319,84362,34,3195,31370,1318783,2493,101573
6/16/2020 0:00,Los Angeles,County,10257557,2187,86549,25,3220,29829,1348612,2483,104056
6/17/2020 0:00,Los Angeles,County,10257557,2321,88870,41,3261,29339,1377951,2729,106785
6/18/2020 0:00,Los Angeles,County,10257557,2308,91178,31,3292,29825,1407776,2798,109583
6/19/2020 0:00,Los Angeles,County,10257557,2270,93448,38,3330,30551,1438327,2638,112221
6/20/2020 0:00,Los Angeles,County,10257557,1989,95437,40,3370,17657,1455984,2069,114290
6/21/2020 0:00,Los Angeles,County,10257557,1574,97011,32,3402,9433,1465417,1096,115386
6/22/2020 0:00,Los Angeles,County,10257557,2892,99903,31,3433,33478,1498895,2974,118360
6/23/2020 0:00,Los Angeles,County,10257557,2899,102802,23,3456,35342,1534237,3223,121583
6/24/2020 0:00,Los Angeles,County,10257557,2944,105746,41,3497,37149,1571386,3454,125037
6/25/2020 0:00,Los Angeles,County,10257557,2760,108506,28,3525,42184,1613570,3793,128830
6/26/2020 0:00,Los Angeles,County,10257557,2768,111274,33,3558,41804,1655374,3690,132520
6/27/2020 0:00,Los Angeles,County,10257557,2163,113437,26,3584,27390,1682764,2731,135251
6/28/2020 0:00,Los Angeles,County,10257557,1742,115179,42,3626,11011,1693775,1158,136409
6/29/2020 0:00,Los Angeles,County,10257557,3204,118383,36,3662,41447,1735222,3756,140165
6/30/2020 0:00,Los Angeles,County,10257557,3036,121419,38,3700,41672,1776894,3897,144062
7/1/2020 0:00,Los Angeles,County,10257557,3583,125002,32,3732,44779,1821673,4211,148273
7/2/2020 0:00,Los Angeles,County,10257557,3198,128200,44,3776,47981,1869654,4169,152442
7/3/2020 0:00,Los Angeles,County,10257557,2018,130218,33,3809,19825,1889479,1934,154376
7/4/2020 0:00,Los Angeles,County,10257557,1513,131731,30,3839,7333,1896812,987,155363
7/5/2020 0:00,Los Angeles,County,10257557,1816,133547,44,3883,11011,1907823,1324,156687
7/6/2020 0:00,Los Angeles,County,10257557,3231,136778,36,3919,37773,1945596,3444,160131
7/7/2020 0:00,Los Angeles,County,10257557,3600,140378,34,3953,48230,1993826,4435,164566
7/8/2020 0:00,Los Angeles,County,10257557,3579,143957,39,3992,49872,2043698,4502,169068
7/9/2020 0:00,Los Angeles,County,10257557,3207,147164,36,4028,49148,2092846,4476,173544
7/10/2020 0:00,Los Angeles,County,10257557,3260,150424,43,4071,47893,2140739,4143,177687
7/11/2020 0:00,Los Angeles,County,10257557,2423,152847,34,4105,32550,2173289,3174,180861
7/12/2020 0:00,Los Angeles,County,10257557,1718,154565,30,4135,12492,2185781,1398,182259
7/13/2020 0:00,Los Angeles,County,10257557,3425,157990,58,4193,52565,2238346,4585,186844
7/14/2020 0:00,Los Angeles,County,10257557,3234,161224,50,4243,54178,2292524,4420,191264
7/15/2020 0:00,Los Angeles,County,10257557,3139,164363,40,4283,56328,2348852,4171,195435
7/16/2020 0:00,Los Angeles,County,10257557,3468,167831,48,4331,58941,2407793,4275,199710
7/17/2020 0:00,Los Angeles,County,10257557,3224,171055,38,4369,55090,2462883,4255,203965
7/18/2020 0:00,Los Angeles,County,10257557,2373,173428,32,4401,34427,2497310,3016,206981
7/19/2020 0:00,Los Angeles,County,10257557,1446,174874,39,4440,19097,2516407,1214,208195
7/20/2020 0:00,Los Angeles,County,10257557,3446,178320,42,4482,65459,2581866,4688,212883
7/21/2020 0:00,Los Angeles,County,10257557,2963,181283,46,4528,64969,2646835,4445,217328
7/22/2020 0:00,Los Angeles,County,10257557,2988,184271,52,4580,57399,2704234,4087,221415
7/23/2020 0:00,Los Angeles,County,10257557,2650,186921,41,4621,51545,2755779,3746,225161
7/24/2020 0:00,Los Angeles,County,10257557,2551,189472,41,4662,41248,2797027,3838,228999
7/25/2020 0:00,Los Angeles,County,10257557,2025,191497,49,4711,30369,2827396,3036,232035
7/26/2020 0:00,Los Angeles,County,10257557,1135,192632,48,4759,13772,2841168,1029,233064
7/27/2020 0:00,Los Angeles,County,10257557,2567,195199,45,4804,62887,2904055,3898,236962
7/28/2020 0:00,Los Angeles,County,10257557,2426,197625,36,4840,59450,2963505,3643,240605
7/29/2020 0:00,Los Angeles,County,10257557,2233,199858,42,4882,54497,3018002,3487,244092
7/30/2020 0:00,Los Angeles,County,10257557,2025,201883,43,4925,51649,3069651,3337,247429
7/31/2020 0:00,Los Angeles,County,10257557,2029,203912,41,4966,53041,3122692,3360,250789
8/1/2020 0:00,Los Angeles,County,10257557,1599,205511,46,5012,32239,3154931,2431,253220
8/2/2020 0:00,Los Angeles,County,10257557,892,206403,41,5053,13272,3168203,927,254147
8/3/2020 0:00,Los Angeles,County,10257557,2093,208496,42,5095,48527,3216730,3359,257506
8/4/2020 0:00,Los Angeles,County,10257557,2037,210533,53,5148,56678,3273408,3279,260785
8/5/2020 0:00,Los Angeles,County,10257557,1941,212474,35,5183,49761,3323169,2893,263678
8/6/2020 0:00,Los Angeles,County,10257557,1921,214395,37,5220,48193,3371362,2850,266528
8/7/2020 0:00,Los Angeles,County,10257557,2073,216468,34,5254,45780,3417142,3013,269541
8/8/2020 0:00,Los Angeles,County,10257557,1467,217935,37,5291,26913,3444055,2008,271549
8/9/2020 0:00,Los Angeles,County,10257557,883,218818,40,5331,12320,3456375,858,272407
8/10/2020 0:00,Los Angeles,County,10257557,2061,220879,46,5377,46465,3502840,3087,275494
8/11/2020 0:00,Los Angeles,County,10257557,1578,222457,46,5423,45580,3548420,2503,277997
8/12/2020 0:00,Los Angeles,County,10257557,1500,223957,35,5458,46429,3594849,2602,280599
8/13/2020 0:00,Los Angeles,County,10257557,1398,225355,31,5489,40241,3635090,2293,282892
8/14/2020 0:00,Los Angeles,County,10257557,1380,226735,34,5523,36795,3671885,2291,285183
8/15/2020 0:00,Los Angeles,County,10257557,1174,227909,37,5560,23871,3695756,1795,286978
8/16/2020 0:00,Los Angeles,County,10257557,751,228660,39,5599,10501,3706257,733,287711
8/17/2020 0:00,Los Angeles,County,10257557,1570,230230,40,5639,40376,3746633,2399,290110
8/18/2020 0:00,Los Angeles,County,10257557,1519,231749,30,5669,40232,3786865,2132,292242
8/19/2020 0:00,Los Angeles,County,10257557,1267,233016,44,5713,41829,3828694,2097,294339
8/20/2020 0:00,Los Angeles,County,10257557,1277,234293,38,5751,36541,3865235,1975,296314
8/21/2020 0:00,Los Angeles,County,10257557,1235,235528,35,5786,38216,3903451,2099,298413
8/22/2020 0:00,Los Angeles,County,10257557,876,236404,42,5828,22500,3925951,1470,299883
8/23/2020 0:00,Los Angeles,County,10257557,661,237065,30,5858,10280,3936231,706,300589
8/24/2020 0:00,Los Angeles,County,10257557,1602,238667,27,5885,39737,3975968,2210,302799
8/25/2020 0:00,Los Angeles,County,10257557,1365,240032,33,5918,39714,4015682,1867,304666
8/26/2020 0:00,Los Angeles,County,10257557,1297,241329,27,5945,43687,4059369,1951,306617
8/27/2020 0:00,Los Angeles,County,10257557,1010,242339,32,5977,35177,4094546,1741,308358
8/28/2020 0:00,Los Angeles,County,10257557,1001,243340,24,6001,35029,4129575,1706,310064
8/29/2020 0:00,Los Angeles,County,10257557,813,244153,34,6035,22061,4151636,1307,311371
8/30/2020 0:00,Los Angeles,County,10257557,629,244782,33,6068,10159,4161795,510,311881
8/31/2020 0:00,Los Angeles,County,10257557,1138,245920,31,6099,39350,4201145,1881,313762
9/1/2020 0:00,Los Angeles,County,10257557,1107,247027,29,6128,39924,4241069,1499,315261
9/2/2020 0:00,Los Angeles,County,10257557,1090,248117,25,6153,42726,4283795,1733,316994
9/3/2020 0:00,Los Angeles,County,10257557,931,249048,25,6178,35622,4319417,1522,318516
9/4/2020 0:00,Los Angeles,County,10257557,863,249911,31,6209,34458,4353875,1518,320034
9/5/2020 0:00,Los Angeles,County,10257557,569,250480,23,6232,12032,4365907,594,320628
9/6/2020 0:00,Los Angeles,County,10257557,535,251015,23,6255,9329,4375236,496,321124
9/7/2020 0:00,Los Angeles,County,10257557,632,251647,28,6283,10130,4385366,477,321601
9/8/2020 0:00,Los Angeles,County,10257557,1048,252695,31,6314,46883,4432249,1765,323366
9/9/2020 0:00,Los Angeles,County,10257557,933,253628,29,6343,42444,4474693,1530,324896
9/10/2020 0:00,Los Angeles,County,10257557,873,254501,25,6368,39787,4514480,1314,326210
9/11/2020 0:00,Los Angeles,County,10257557,978,255479,26,6394,39156,4553636,1384,327594
9/12/2020 0:00,Los Angeles,County,10257557,679,256158,19,6413,21762,4575398,958,328552
9/13/2020 0:00,Los Angeles,County,10257557,559,256717,19,6432,9292,4584690,370,328922
9/14/2020 0:00,Los Angeles,County,10257557,1153,257870,18,6450,41945,4626635,1666,330588
9/15/2020 0:00,Los Angeles,County,10257557,1029,258899,21,6471,42199,4668834,1302,331890
9/16/2020 0:00,Los Angeles,County,10257557,1109,260008,19,6490,45396,4714230,1606,333496
9/17/2020 0:00,Los Angeles,County,10257557,981,260989,19,6509,43020,4757250,1429,334925
9/18/2020 0:00,Los Angeles,County,10257557,943,261932,14,6523,39747,4796997,1408,336333
9/19/2020 0:00,Los Angeles,County,10257557,762,262694,18,6541,21672,4818669,1023,337356
9/20/2020 0:00,Los Angeles,County,10257557,624,263318,15,6556,10299,4828968,552,337908
9/21/2020 0:00,Los Angeles,County,10257557,1228,264546,16,6572,46502,4875470,1665,339573
9/22/2020 0:00,Los Angeles,County,10257557,1086,265632,20,6592,46607,4922077,1353,340926
9/23/2020 0:00,Los Angeles,County,10257557,1066,266698,30,6622,49035,4971112,1514,342440
9/24/2020 0:00,Los Angeles,County,10257557,1019,267717,19,6641,43325,5014437,1549,343989
9/25/2020 0:00,Los Angeles,County,10257557,1042,268759,17,6658,39685,5054122,1529,345518
9/26/2020 0:00,Los Angeles,County,10257557,794,269553,21,6679,21876,5075998,1089,346607
9/27/2020 0:00,Los Angeles,County,10257557,633,270186,21,6700,10691,5086689,548,347155
9/28/2020 0:00,Los Angeles,County,10257557,1180,271366,21,6721,41467,5128156,1521,348676
9/29/2020 0:00,Los Angeles,County,10257557,1107,272473,11,6732,46378,5174534,1481,350157
9/30/2020 0:00,Los Angeles,County,10257557,1215,273688,14,6746,48227,5222761,1543,351700
10/1/2020 0:00,Los Angeles,County,10257557,1222,274910,13,6759,43950,5266711,1646,353346
10/2/2020 0:00,Los Angeles,County,10257557,1048,275958,11,6770,47986,5314697,1554,354900
10/3/2020 0:00,Los Angeles,County,10257557,901,276859,12,6782,25920,5340617,1119,356019
10/4/2020 0:00,Los Angeles,County,10257557,707,277566,18,6800,12057,5352674,506,356525
10/5/2020 0:00,Los Angeles,County,10257557,1388,278954,16,6816,53623,5406297,1870,358395
10/6/2020 0:00,Los Angeles,County,10257557,1097,280051,17,6833,54378,5460675,1428,359823
10/7/2020 0:00,Los Angeles,County,10257557,1238,281289,20,6853,56921,5517596,1741,361564
10/8/2020 0:00,Los Angeles,County,10257557,1184,282473,22,6875,51193,5568789,1599,363163
10/9/2020 0:00,Los Angeles,County,10257557,1204,283677,13,6888,50748,5619537,1720,364883
10/10/2020 0:00,Los Angeles,County,10257557,1135,284812,9,6897,26065,5645602,1386,366269
10/11/2020 0:00,Los Angeles,County,10257557,718,285530,16,6913,12551,5658153,588,366857
10/12/2020 0:00,Los Angeles,County,10257557,1436,286966,15,6928,53933,5712086,1940,368797
10/13/2020 0:00,Los Angeles,County,10257557,1220,288186,20,6948,54501,5766587,1578,370375
10/14/2020 0:00,Los Angeles,County,10257557,1281,289467,17,6965,58766,5825353,1728,372103
10/15/2020 0:00,Los Angeles,County,10257557,1315,290782,14,6979,53105,5878458,1795,373898
10/16/2020 0:00,Los Angeles,County,10257557,1285,292067,21,7000,53176,5931634,1838,375736
10/17/2020 0:00,Los Angeles,County,10257557,1064,293131,12,7012,25380,5957014,1333,377069
10/18/2020 0:00,Los Angeles,County,10257557,754,293885,9,7021,12407,5969421,696,377765
10/19/2020 0:00,Los Angeles,County,10257557,1711,295596,17,7038,59385,6028806,2304,380069
10/20/2020 0:00,Los Angeles,County,10257557,1485,297081,14,7052,58038,6086844,1957,382026
10/21/2020 0:00,Los Angeles,County,10257557,1495,298576,14,7066,60110,6146954,1972,383998
10/22/2020 0:00,Los Angeles,County,10257557,1341,299917,14,7080,54718,6201672,1907,385905
10/23/2020 0:00,Los Angeles,County,10257557,1379,301296,21,7101,53567,6255239,2129,388034
10/24/2020 0:00,Los Angeles,County,10257557,1086,302382,14,7115,27171,6282410,1427,389461
10/25/2020 0:00,Los Angeles,County,10257557,820,303202,17,7132,14095,6296505,631,390092
10/26/2020 0:00,Los Angeles,County,10257557,1564,304766,13,7145,63951,6360456,2186,392278
10/27/2020 0:00,Los Angeles,County,10257557,1427,306193,18,7163,63449,6423905,1905,394183
10/28/2020 0:00,Los Angeles,County,10257557,1388,307581,13,7176,65032,6488937,1770,395953
10/29/2020 0:00,Los Angeles,County,10257557,1455,309036,18,7194,60925,6549862,2072,398025
10/30/2020 0:00,Los Angeles,County,10257557,1628,310664,9,7203,54484,6604346,2223,400248
10/31/2020 0:00,Los Angeles,County,10257557,1436,312100,15,7218,28159,6632505,1681,401929
11/1/2020 0:00,Los Angeles,County,10257557,1379,313479,18,7236,14275,6646780,850,402779
11/2/2020 0:00,Los Angeles,County,10257557,2571,316050,13,7249,68346,6715126,3012,405791
11/3/2020 0:00,Los Angeles,County,10257557,2348,318398,13,7262,64077,6779203,2655,408446
11/4/2020 0:00,Los Angeles,County,10257557,2457,320855,12,7274,69046,6848249,3042,411488
11/5/2020 0:00,Los Angeles,County,10257557,2312,323167,10,7284,64749,6912998,3074,414562
11/6/2020 0:00,Los Angeles,County,10257557,2355,325522,18,7302,64821,6977819,3136,417698
11/7/2020 0:00,Los Angeles,County,10257557,1970,327492,13,7315,34543,7012362,2271,419969
11/8/2020 0:00,Los Angeles,County,10257557,1513,329005,15,7330,16041,7028403,1019,420988
11/9/2020 0:00,Los Angeles,County,10257557,3128,332133,17,7347,74507,7102910,3639,424627
11/10/2020 0:00,Los Angeles,County,10257557,3096,335229,17,7364,72907,7175817,3496,428123
11/11/2020 0:00,Los Angeles,County,10257557,3253,338482,13,7377,71490,7247307,3712,431835
11/12/2020 0:00,Los Angeles,County,10257557,3371,341853,20,7397,75796,7323103,4164,435999
11/13/2020 0:00,Los Angeles,County,10257557,3746,345599,22,7419,75982,7399085,4675,440674
11/14/2020 0:00,Los Angeles,County,10257557,3130,348729,17,7436,45594,7444679,3646,444320
11/15/2020 0:00,Los Angeles,County,10257557,2710,351439,23,7459,23153,7467832,2042,446362
11/16/2020 0:00,Los Angeles,County,10257557,5049,356488,26,7485,87612,7555444,5741,452103
11/17/2020 0:00,Los Angeles,County,10257557,4759,361247,35,7520,92162,7647606,5686,457789
11/18/2020 0:00,Los Angeles,County,10257557,4955,366202,22,7542,94439,7742045,5824,463613
11/19/2020 0:00,Los Angeles,County,10257557,4882,371084,36,7578,90323,7832368,5837,469450
11/20/2020 0:00,Los Angeles,County,10257557,5029,376113,24,7602,92086,7924454,6239,475689
11/21/2020 0:00,Los Angeles,County,10257557,3896,380009,34,7636,59892,7984346,4522,480211
11/22/2020 0:00,Los Angeles,County,10257557,3187,383196,37,7673,33969,8018315,2633,482844
11/23/2020 0:00,Los Angeles,County,10257557,6288,389484,39,7712,110477,8128792,6717,489561
11/24/2020 0:00,Los Angeles,County,10257557,6110,395594,34,7746,111131,8239923,7388,496949
11/25/2020 0:00,Los Angeles,County,10257557,6310,401904,38,7784,92537,8332460,7745,504694
11/26/2020 0:00,Los Angeles,County,10257557,3028,404932,33,7817,9963,8342423,1290,505984
11/27/2020 0:00,Los Angeles,County,10257557,5169,410101,34,7851,39093,8381516,4557,510541
11/28/2020 0:00,Los Angeles,County,10257557,6525,416626,46,7897,62947,8444463,8730,519271
11/29/2020 0:00,Los Angeles,County,10257557,4919,421545,35,7932,29441,8473904,3696,522967
11/30/2020 0:00,Los Angeles,County,10257557,10410,431955,48,7980,123262,8597166,12334,535301
12/1/2020 0:00,Los Angeles,County,10257557,10683,442638,53,8033,118607,8715773,12685,547986
12/2/2020 0:00,Los Angeles,County,10257557,10380,453018,53,8086,114780,8830553,12647,560633
12/3/2020 0:00,Los Angeles,County,10257557,10058,463076,73,8159,117878,8948431,13000,573633
12/4/2020 0:00,Los Angeles,County,10257557,10102,473178,60,8219,114859,9063290,12706,586339
12/5/2020 0:00,Los Angeles,County,10257557,8622,481800,68,8287,69204,9132494,10074,596413
12/6/2020 0:00,Los Angeles,County,10257557,5799,487599,62,8349,31895,9164389,5143,601556
12/7/2020 0:00,Los Angeles,County,10257557,13599,501198,87,8436,128262,9292651,15945,617501
12/8/2020 0:00,Los Angeles,County,10257557,13675,514873,65,8501,122060,9414711,16522,634023
12/9/2020 0:00,Los Angeles,County,10257557,12716,527589,71,8572,115639,9530350,15381,649404
12/10/2020 0:00,Los Angeles,County,10257557,13507,541096,96,8668,114553,9644903,16178,665582
12/11/2020 0:00,Los Angeles,County,10257557,13984,555080,118,8786,114566,9759469,16516,682098
12/12/2020 0:00,Los Angeles,County,10257557,11812,566892,100,8886,73134,9832603,13673,695771
12/13/2020 0:00,Los Angeles,County,10257557,6820,573712,119,9005,36527,9869130,6351,702122
12/14/2020 0:00,Los Angeles,County,10257557,17645,591357,126,9131,137007,10006137,20038,722160
12/15/2020 0:00,Los Angeles,County,10257557,17649,609006,116,9247,129859,10135996,21903,744063
12/16/2020 0:00,Los Angeles,County,10257557,16405,625411,136,9383,129931,10265927,20641,764704
12/17/2020 0:00,Los Angeles,County,10257557,16546,641957,146,9529,131932,10397859,20871,785575
12/18/2020 0:00,Los Angeles,County,10257557,15686,657643,164,9693,126946,10524805,20190,805765
12/19/2020 0:00,Los Angeles,County,10257557,12153,669796,162,9855,79900,10604705,15249,821014
12/20/2020 0:00,Los Angeles,County,10257557,7128,676924,174,10029,39965,10644670,7051,828065
12/21/2020 0:00,Los Angeles,County,10257557,18110,695034,188,10217,144514,10789184,21481,849546
12/22/2020 0:00,Los Angeles,County,10257557,19100,714134,182,10399,135434,10924618,22947,872493
12/23/2020 0:00,Los Angeles,County,10257557,17279,731413,188,10587,131258,11055876,22724,895217
12/24/2020 0:00,Los Angeles,County,10257557,9076,740489,216,10803,53147,11109023,9225,904442
12/25/2020 0:00,Los Angeles,County,10257557,4195,744684,203,11006,10316,11119339,2669,907111
12/26/2020 0:00,Los Angeles,County,10257557,13675,758359,246,11252,73572,11192911,17939,925050
12/27/2020 0:00,Los Angeles,County,10257557,8581,766940,262,11514,39729,11232640,8351,933401
12/28/2020 0:00,Los Angeles,County,10257557,21536,788476,237,11751,135465,11368105,25167,958568
12/29/2020 0:00,Los Angeles,County,10257557,22367,810843,199,11950,138133,11506238,29032,987600
12/30/2020 0:00,Los Angeles,County,10257557,20215,831058,241,12191,132338,11638576,26352,1013952
12/31/2020 0:00,Los Angeles,County,10257557,10923,841981,277,12468,64749,11703325,11781,1025733
1/1/2021 0:00,Los Angeles,County,10257557,5347,847328,277,12745,16110,11719435,3480,1029213
1/2/2021 0:00,Los Angeles,County,10257557,14221,861549,254,12999,79495,11798930,18254,1047467
1/3/2021 0:00,Los Angeles,County,10257557,8376,869925,280,13279,42397,11841327,8083,1055550
1/4/2021 0:00,Los Angeles,County,10257557,22070,891995,296,13575,158045,11999372,26941,1082491
1/5/2021 0:00,Los Angeles,County,10257557,20152,912147,283,13858,147998,12147370,25977,1108468
1/6/2021 0:00,Los Angeles,County,10257557,18739,930886,306,14164,142663,12290033,23881,1132349
1/7/2021 0:00,Los Angeles,County,10257557,15963,946849,279,14443,139407,12429440,21379,1153728
1/8/2021 0:00,Los Angeles,County,10257557,14925,961774,288,14731,129963,12559403,20932,1174660
1/9/2021 0:00,Los Angeles,County,10257557,10814,972588,302,15033,81927,12641330,15214,1189874
1/10/2021 0:00,Los Angeles,County,10257557,5583,978171,301,15334,39522,12680852,6004,1195878
1/11/2021 0:00,Los Angeles,County,10257557,14621,992792,300,15634,148504,12829356,19443,1215321
1/12/2021 0:00,Los Angeles,County,10257557,13228,1006020,292,15926,124841,12954197,17180,1232501
1/13/2021 0:00,Los Angeles,County,10257557,11664,1017684,260,16186,123379,13077576,16355,1248856
1/14/2021 0:00,Los Angeles,County,10257557,10795,1028479,279,16465,124861,13202437,16196,1265052
1/15/2021 0:00,Los Angeles,County,10257557,10028,1038507,300,16765,114608,13317045,15032,1280084
1/16/2021 0:00,Los Angeles,County,10257557,7054,1045561,250,17015,63721,13380766,10738,1290822
1/17/2021 0:00,Los Angeles,County,10257557,4087,1049648,266,17281,37397,13418163,4951,1295773
1/18/2021 0:00,Los Angeles,County,10257557,6664,1056312,249,17530,88275,13506438,8357,1304130
1/19/2021 0:00,Los Angeles,County,10257557,9512,1065824,216,17746,129692,13636130,14338,1318468
1/20/2021 0:00,Los Angeles,County,10257557,8674,1074498,243,17989,116522,13752652,12931,1331399
1/21/2021 0:00,Los Angeles,County,10257557,7502,1082000,219,18208,111209,13863861,11862,1343261
1/22/2021 0:00,Los Angeles,County,10257557,6666,1088666,220,18428,103152,13967013,11185,1354446
1/23/2021 0:00,Los Angeles,County,10257557,4470,1093136,204,18632,47645,14014658,6911,1361357
1/24/2021 0:00,Los Angeles,County,10257557,3240,1096376,166,18798,31857,14046515,4301,1365658
1/25/2021 0:00,Los Angeles,County,10257557,6422,1102798,237,19035,109594,14156109,9495,1375153
1/26/2021 0:00,Los Angeles,County,10257557,5964,1108762,189,19224,98232,14254341,8927,1384080
1/27/2021 0:00,Los Angeles,County,10257557,5292,1114054,166,19390,94155,14348496,8443,1392523
1/28/2021 0:00,Los Angeles,County,10257557,4813,1118867,189,19579,91357,14439853,7418,1399941
1/29/2021 0:00,Los Angeles,County,10257557,3913,1122780,175,19754,79251,14519104,6341,1406282
1/30/2021 0:00,Los Angeles,County,10257557,3497,1126277,184,19938,45718,14564822,6078,1412360
1/31/2021 0:00,Los Angeles,County,10257557,2397,1128674,165,20103,29341,14594163,2982,1415342
2/1/2021 0:00,Los Angeles,County,10257557,4633,1133307,187,20290,105559,14699722,7028,1422370
2/2/2021 0:00,Los Angeles,County,10257557,3829,1137136,153,20443,87684,14787406,5993,1428363
2/3/2021 0:00,Los Angeles,County,10257557,3382,1140518,161,20604,87439,14874845,5716,1434079
2/4/2021 0:00,Los Angeles,County,10257557,3085,1143603,137,20741,86664,14961509,5277,1439356
2/5/2021 0:00,Los Angeles,County,10257557,2799,1146402,164,20905,82208,15043717,5170,1444526
2/6/2021 0:00,Los Angeles,County,10257557,2101,1148503,119,21024,38940,15082657,3822,1448348
2/7/2021 0:00,Los Angeles,County,10257557,1356,1149859,130,21154,24291,15106948,1808,1450156
2/8/2021 0:00,Los Angeles,County,10257557,2762,1152621,150,21304,94914,15201862,4414,1454570
2/9/2021 0:00,Los Angeles,County,10257557,2097,1154718,123,21427,78948,15280810,3629,1458199
2/10/2021 0:00,Los Angeles,County,10257557,1978,1156696,121,21548,76468,15357278,3522,1461721
2/11/2021 0:00,Los Angeles,County,10257557,1748,1158444,146,21694,75761,15433039,3187,1464908
2/12/2021 0:00,Los Angeles,County,10257557,1628,1160072,111,21805,63713,15496752,2982,1467890
2/13/2021 0:00,Los Angeles,County,10257557,1214,1161286,89,21894,30316,15527068,2287,1470177
2/14/2021 0:00,Los Angeles,County,10257557,859,1162145,93,21987,19645,15546713,1183,1471360
2/15/2021 0:00,Los Angeles,County,10257557,1346,1163491,91,22078,56619,15603332,2053,1473413
2/16/2021 0:00,Los Angeles,County,10257557,1387,1164878,103,22181,85276,15688608,2729,1476142
2/17/2021 0:00,Los Angeles,County,10257557,1254,1166132,92,22273,72829,15761437,2381,1478523
2/18/2021 0:00,Los Angeles,County,10257557,1055,1167187,101,22374,71307,15832744,1935,1480458
2/19/2021 0:00,Los Angeles,County,10257557,951,1168138,99,22473,64096,15896840,1854,1482312
2/20/2021 0:00,Los Angeles,County,10257557,752,1168890,70,22543,28151,15924991,1389,1483701
2/21/2021 0:00,Los Angeles,County,10257557,570,1169460,80,22623,20428,15945419,843,1484544
2/22/2021 0:00,Los Angeles,County,10257557,1042,1170502,77,22700,80689,16026108,1832,1486376
2/23/2021 0:00,Los Angeles,County,10257557,860,1171362,58,22758,71679,16097787,1522,1487898
2/24/2021 0:00,Los Angeles,County,10257557,873,1172235,71,22829,68072,16165859,1520,1489418
2/25/2021 0:00,Los Angeles,County,10257557,759,1172994,70,22899,66910,16232769,1408,1490826
2/26/2021 0:00,Los Angeles,County,10257557,748,1173742,70,22969,58101,16290870,1347,1492173
2/27/2021 0:00,Los Angeles,County,10257557,577,1174319,63,23032,26867,16317737,1020,1493193
2/28/2021 0:00,Los Angeles,County,10257557,501,1174820,79,23111,19552,16337289,581,1493774
3/1/2021 0:00,Los Angeles,County,10257557,788,1175608,56,23167,79633,16416922,1272,1495046
3/2/2021 0:00,Los Angeles,County,10257557,659,1176267,52,23219,67638,16484560,1139,1496185
3/3/2021 0:00,Los Angeles,County,10257557,637,1176904,47,23266,61146,16545706,1042,1497227
3/4/2021 0:00,Los Angeles,County,10257557,639,1177543,47,23313,61566,16607272,1093,1498320
3/5/2021 0:00,Los Angeles,County,10257557,611,1178154,42,23355,56421,16663693,1068,1499388
3/6/2021 0:00,Los Angeles,County,10257557,492,1178646,37,23392,22967,16686660,759,1500147
3/7/2021 0:00,Los Angeles,County,10257557,440,1179086,37,23429,16759,16703419,536,1500683
3/8/2021 0:00,Los Angeles,County,10257557,727,1179813,37,23466,79024,16782443,1196,1501879
3/9/2021 0:00,Los Angeles,County,10257557,621,1180434,34,23500,65732,16848175,890,1502769
3/10/2021 0:00,Los Angeles,County,10257557,597,1181031,34,23534,62725,16910900,936,1503705
3/11/2021 0:00,Los Angeles,County,10257557,547,1181578,28,23562,57702,16968602,948,1504653
3/12/2021 0:00,Los Angeles,County,10257557,533,1182111,39,23601,52396,17020998,912,1505565
3/13/2021 0:00,Los Angeles,County,10257557,395,1182506,37,23638,22677,17043675,630,1506195
3/14/2021 0:00,Los Angeles,County,10257557,318,1182824,26,23664,15386,17059061,404,1506599
3/15/2021 0:00,Los Angeles,County,10257557,577,1183401,15,23679,72532,17131593,839,1507438
3/16/2021 0:00,Los Angeles,County,10257557,572,1183973,28,23707,62022,17193615,880,1508318
3/17/2021 0:00,Los Angeles,County,10257557,532,1184505,31,23738,61459,17255074,872,1509190
3/18/2021 0:00,Los Angeles,County,10257557,454,1184959,34,23772,54106,17309180,779,1509969
3/19/2021 0:00,Los Angeles,County,10257557,433,1185392,26,23798,51492,17360672,813,1510782
3/20/2021 0:00,Los Angeles,County,10257557,340,1185732,31,23829,22658,17383330,554,1511336
3/21/2021 0:00,Los Angeles,County,10257557,298,1186030,20,23849,16011,17399341,380,1511716
3/22/2021 0:00,Los Angeles,County,10257557,536,1186566,20,23869,79491,17478832,844,1512560
3/23/2021 0:00,Los Angeles,County,10257557,517,1187083,15,23884,65416,17544248,749,1513309
3/24/2021 0:00,Los Angeles,County,10257557,521,1187604,18,23902,63751,17607999,872,1514181
3/25/2021 0:00,Los Angeles,County,10257557,487,1188091,20,23922,59259,17667258,804,1514985
3/26/2021 0:00,Los Angeles,County,10257557,438,1188529,20,23942,49281,17716539,736,1515721
3/27/2021 0:00,Los Angeles,County,10257557,336,1188865,18,23960,21936,17738475,499,1516220
3/28/2021 0:00,Los Angeles,County,10257557,314,1189179,13,23973,16562,17755037,343,1516563
3/29/2021 0:00,Los Angeles,County,10257557,552,1189731,13,23986,73941,17828978,789,1517352
3/30/2021 0:00,Los Angeles,County,10257557,497,1190228,14,24000,62204,17891182,739,1518091
3/31/2021 0:00,Los Angeles,County,10257557,496,1190724,12,24012,55075,17946257,767,1518858
4/1/2021 0:00,Los Angeles,County,10257557,468,1191192,12,24024,49530,17995787,664,1519522
4/2/2021 0:00,Los Angeles,County,10257557,493,1191685,11,24035,40732,18036519,736,1520258
4/3/2021 0:00,Los Angeles,County,10257557,309,1191994,7,24042,21063,18057582,469,1520727
4/4/2021 0:00,Los Angeles,County,10257557,306,1192300,15,24057,13422,18071004,273,1521000
4/5/2021 0:00,Los Angeles,County,10257557,545,1192845,15,24072,85924,18156928,717,1521717
4/6/2021 0:00,Los Angeles,County,10257557,536,1193381,9,24081,71801,18228729,793,1522510
4/7/2021 0:00,Los Angeles,County,10257557,513,1193894,16,24097,70524,18299253,808,1523318
4/8/2021 0:00,Los Angeles,County,10257557,442,1194336,11,24108,65907,18365160,719,1524037
4/9/2021 0:00,Los Angeles,County,10257557,499,1194835,12,24120,62017,18427177,752,1524789
4/10/2021 0:00,Los Angeles,County,10257557,369,1195204,12,24132,28096,18455273,482,1525271
4/11/2021 0:00,Los Angeles,County,10257557,275,1195479,7,24139,21688,18476961,354,1525625
4/12/2021 0:00,Los Angeles,County,10257557,512,1195991,5,24144,95996,18572957,682,1526307
4/13/2021 0:00,Los Angeles,County,10257557,503,1196494,9,24153,83658,18656615,743,1527050
4/14/2021 0:00,Los Angeles,County,10257557,454,1196948,13,24166,86649,18743264,732,1527782
4/15/2021 0:00,Los Angeles,County,10257557,399,1197347,10,24176,81792,18825056,660,1528442
4/16/2021 0:00,Los Angeles,County,10257557,405,1197752,8,24184,80362,18905418,651,1529093
4/17/2021 0:00,Los Angeles,County,10257557,300,1198052,7,24191,40293,18945711,456,1529549
4/18/2021 0:00,Los Angeles,County,10257557,260,1198312,11,24202,25849,18971560,291,1529840
4/19/2021 0:00,Los Angeles,County,10257557,460,1198772,6,24208,96994,19068554,599,1530439
4/20/2021 0:00,Los Angeles,County,10257557,379,1199151,5,24213,89382,19157936,571,1531010
4/21/2021 0:00,Los Angeles,County,10257557,347,1199498,13,24226,92185,19250121,620,1531630
4/22/2021 0:00,Los Angeles,County,10257557,342,1199840,7,24233,80420,19330541,551,1532181
4/23/2021 0:00,Los Angeles,County,10257557,322,1200162,6,24239,73656,19404197,519,1532700
4/24/2021 0:00,Los Angeles,County,10257557,270,1200432,8,24247,34142,19438339,401,1533101
4/25/2021 0:00,Los Angeles,County,10257557,232,1200664,4,24251,25924,19464263,299,1533400
4/26/2021 0:00,Los Angeles,County,10257557,336,1201000,8,24259,93791,19558054,440,1533840
4/27/2021 0:00,Los Angeles,County,10257557,329,1201329,8,24267,86322,19644376,518,1534358
4/28/2021 0:00,Los Angeles,County,10257557,322,1201651,4,24271,84472,19728848,465,1534823
4/29/2021 0:00,Los Angeles,County,10257557,302,1201953,6,24277,75871,19804719,507,1535330
4/30/2021 0:00,Los Angeles,County,10257557,278,1202231,5,24282,68041,19872760,474,1535804
5/1/2021 0:00,Los Angeles,County,10257557,210,1202441,5,24287,21826,19894586,314,1536118
5/2/2021 0:00,Los Angeles,County,10257557,170,1202611,5,24292,16401,19910987,200,1536318
5/3/2021 0:00,Los Angeles,County,10257557,352,1202963,5,24297,94378,20005365,472,1536790
5/4/2021 0:00,Los Angeles,County,10257557,268,1203231,5,24302,88554,20093919,464,1537254
5/5/2021 0:00,Los Angeles,County,10257557,290,1203521,8,24310,86333,20180252,419,1537673
5/6/2021 0:00,Los Angeles,County,10257557,267,1203788,6,24316,82021,20262273,435,1538108
5/7/2021 0:00,Los Angeles,County,10257557,242,1204030,5,24321,65050,20327323,370,1538478
5/8/2021 0:00,Los Angeles,County,10257557,180,1204210,9,24330,21489,20348812,236,1538714
5/9/2021 0:00,Los Angeles,County,10257557,154,1204364,9,24339,14257,20363069,144,1538858
5/10/2021 0:00,Los Angeles,County,10257557,258,1204622,3,24342,102733,20465802,405,1539263
5/11/2021 0:00,Los Angeles,County,10257557,267,1204889,10,24352,95300,20561102,380,1539643
5/12/2021 0:00,Los Angeles,County,10257557,237,1205126,9,24361,92457,20653559,393,1540036
5/13/2021 0:00,Los Angeles,County,10257557,185,1205311,7,24368,82583,20736142,319,1540355
5/14/2021 0:00,Los Angeles,County,10257557,189,1205500,5,24373,72378,20808520,340,1540695
5/15/2021 0:00,Los Angeles,County,10257557,135,1205635,3,24376,20410,20828930,213,1540908
5/16/2021 0:00,Los Angeles,County,10257557,123,1205758,2,24378,14500,20843430,152,1541060
5/17/2021 0:00,Los Angeles,County,10257557,225,1205983,4,24382,101323,20944753,334,1541394
5/18/2021 0:00,Los Angeles,County,10257557,181,1206164,2,24384,94671,21039424,276,1541670
5/19/2021 0:00,Los Angeles,County,10257557,180,1206344,8,24392,89808,21129232,278,1541948
5/20/2021 0:00,Los Angeles,County,10257557,197,1206541,7,24399,82423,21211655,264,1542212
5/21/2021 0:00,Los Angeles,County,10257557,157,1206698,2,24401,71345,21283000,286,1542498
5/22/2021 0:00,Los Angeles,County,10257557,118,1206816,4,24405,18256,21301256,190,1542688
5/23/2021 0:00,Los Angeles,County,10257557,109,1206925,6,24411,14127,21315383,132,1542820
5/24/2021 0:00,Los Angeles,County,10257557,190,1207115,5,24416,95316,21410699,289,1543109
5/25/2021 0:00,Los Angeles,County,10257557,172,1207287,3,24419,92649,21503348,229,1543338
5/26/2021 0:00,Los Angeles,County,10257557,187,1207474,2,24421,83701,21587049,264,1543602
5/27/2021 0:00,Los Angeles,County,10257557,166,1207640,9,24430,74730,21661779,228,1543830
5/28/2021 0:00,Los Angeles,County,10257557,170,1207810,3,24433,65779,21727558,231,1544061
5/29/2021 0:00,Los Angeles,County,10257557,111,1207921,5,24438,14545,21742103,155,1544216
5/30/2021 0:00,Los Angeles,County,10257557,122,1208043,4,24442,12891,21754994,143,1544359
5/31/2021 0:00,Los Angeles,County,10257557,115,1208158,4,24446,17875,21772869,112,1544471
6/1/2021 0:00,Los Angeles,County,10257557,243,1208401,0,24446,110529,21883398,309,1544780
6/2/2021 0:00,Los Angeles,County,10257557,237,1208638,4,24450,92570,21975968,310,1545090
6/3/2021 0:00,Los Angeles,County,10257557,204,1208842,3,24453,81464,22057432,272,1545362
6/4/2021 0:00,Los Angeles,County,10257557,171,1209013,2,24455,80981,22138413,242,1545604
6/5/2021 0:00,Los Angeles,County,10257557,121,1209134,3,24458,27170,22165583,173,1545777
6/6/2021 0:00,Los Angeles,County,10257557,129,1209263,6,24464,13982,22179565,128,1545905
6/7/2021 0:00,Los Angeles,County,10257557,199,1209462,1,24465,77625,22257190,283,1546188
6/8/2021 0:00,Los Angeles,County,10257557,224,1209686,1,24466,62439,22319629,264,1546452
6/9/2021 0:00,Los Angeles,County,10257557,198,1209884,1,24467,53115,22372744,268,1546720
6/10/2021 0:00,Los Angeles,County,10257557,188,1210072,6,24473,62967,22435711,245,1546965
6/11/2021 0:00,Los Angeles,County,10257557,166,1210238,5,24478,55291,22491002,260,1547225
6/12/2021 0:00,Los Angeles,County,10257557,150,1210388,0,24478,18076,22509078,183,1547408
6/13/2021 0:00,Los Angeles,County,10257557,137,1210525,3,24481,14051,22523129,115,1547523
6/14/2021 0:00,Los Angeles,County,10257557,268,1210793,3,24484,53082,22576211,328,1547851
6/15/2021 0:00,Los Angeles,County,10257557,242,1211035,0,24484,43947,22620158,252,1548103
6/16/2021 0:00,Los Angeles,County,10257557,225,1211260,4,24488,44279,22664437,308,1548411
6/17/2021 0:00,Los Angeles,County,10257557,224,1211484,1,24489,39993,22704430,284,1548695
6/18/2021 0:00,Los Angeles,County,10257557,215,1211699,4,24493,42763,22747193,291,1548986
6/19/2021 0:00,Los Angeles,County,10257557,167,1211866,1,24494,18026,22765219,199,1549185
6/20/2021 0:00,Los Angeles,County,10257557,204,1212070,3,24497,13306,22778525,160,1549345
6/21/2021 0:00,Los Angeles,County,10257557,305,1212375,2,24499,54041,22832566,360,1549705
6/22/2021 0:00,Los Angeles,County,10257557,294,1212669,1,24500,49491,22882057,372,1550077
6/23/2021 0:00,Los Angeles,County,10257557,316,1212985,2,24502,49200,22931257,390,1550467
6/24/2021 0:00,Los Angeles,County,10257557,337,1213322,4,24506,42217,22973474,434,1550901
6/25/2021 0:00,Los Angeles,County,10257557,325,1213647,2,24508,43548,23017022,376,1551277
6/26/2021 0:00,Los Angeles,County,10257557,284,1213931,3,24511,18006,23035028,298,1551575
6/27/2021 0:00,Los Angeles,County,10257557,304,1214235,2,24513,13452,23048480,236,1551811
6/28/2021 0:00,Los Angeles,County,10257557,552,1214787,6,24519,55716,23104196,590,1552401
6/29/2021 0:00,Los Angeles,County,10257557,519,1215306,4,24523,51853,23156049,611,1553012
6/30/2021 0:00,Los Angeles,County,10257557,614,1215920,7,24530,51760,23207809,655,1553667
7/1/2021 0:00,Los Angeles,County,10257557,674,1216594,3,24533,46416,23254225,731,1554398
7/2/2021 0:00,Los Angeles,County,10257557,604,1217198,4,24537,30858,23285083,719,1555117
7/3/2021 0:00,Los Angeles,County,10257557,474,1217672,6,24543,17511,23302594,512,1555629
7/4/2021 0:00,Los Angeles,County,10257557,429,1218101,4,24547,7363,23309957,196,1555825
7/5/2021 0:00,Los Angeles,County,10257557,864,1218965,4,24551,21344,23331301,634,1556459
7/6/2021 0:00,Los Angeles,County,10257557,1194,1220159,5,24556,64951,23396252,1203,1557662
7/7/2021 0:00,Los Angeles,County,10257557,1219,1221378,5,24561,55583,23451835,1340,1559002
7/8/2021 0:00,Los Angeles,County,10257557,1181,1222559,3,24564,49169,23501004,1472,1560474
7/9/2021 0:00,Los Angeles,County,10257557,1214,1223773,7,24571,48803,23549807,1511,1561985
7/10/2021 0:00,Los Angeles,County,10257557,1004,1224777,6,24577,19550,23569357,1109,1563094
7/11/2021 0:00,Los Angeles,County,10257557,1028,1225805,4,24581,13835,23583192,825,1563919
7/12/2021 0:00,Los Angeles,County,10257557,1758,1227563,3,24584,55267,23638459,1852,1565771
7/13/2021 0:00,Los Angeles,County,10257557,1797,1229360,4,24588,56479,23694938,1892,1567663
7/14/2021 0:00,Los Angeles,County,10257557,1851,1231211,5,24593,57751,23752689,2229,1569892
7/15/2021 0:00,Los Angeles,County,10257557,2017,1233228,5,24598,52519,23805208,2442,1572334
7/16/2021 0:00,Los Angeles,County,10257557,1988,1235216,4,24602,54610,23859818,2562,1574896
7/17/2021 0:00,Los Angeles,County,10257557,1501,1236717,6,24608,24087,23883905,1758,1576654
7/18/2021 0:00,Los Angeles,County,10257557,1538,1238255,4,24612,17168,23901073,1214,1577868
7/19/2021 0:00,Los Angeles,County,10257557,2689,1240944,9,24621,67671,23968744,3162,1581030
7/20/2021 0:00,Los Angeles,County,10257557,2605,1243549,8,24629,68459,24037203,3114,1584144
7/21/2021 0:00,Los Angeles,County,10257557,2796,1246345,6,24635,72664,24109867,3397,1587541
7/22/2021 0:00,Los Angeles,County,10257557,2514,1248859,12,24647,62441,24172308,3266,1590807
7/23/2021 0:00,Los Angeles,County,10257557,2440,1251299,16,24663,65533,24237841,3360,1594167
7/24/2021 0:00,Los Angeles,County,10257557,1944,1253243,8,24671,29494,24267335,2326,1596493
7/25/2021 0:00,Los Angeles,County,10257557,1778,1255021,8,24679,18688,24286023,1555,1598048
7/26/2021 0:00,Los Angeles,County,10257557,3422,1258443,6,24685,73793,24359816,4131,1602179
7/27/2021 0:00,Los Angeles,County,10257557,3348,1261791,14,24699,68752,24428568,4105,1606284
7/28/2021 0:00,Los Angeles,County,10257557,3470,1265261,5,24704,72922,24501490,4305,1610589
7/29/2021 0:00,Los Angeles,County,10257557,3176,1268437,13,24717,68073,24569563,4231,1614820
7/30/2021 0:00,Los Angeles,County,10257557,3106,1271543,6,24723,75641,24645204,4281,1619101
7/31/2021 0:00,Los Angeles,County,10257557,2335,1273878,11,24734,34942,24680146,2959,1622060
8/1/2021 0:00,Los Angeles,County,10257557,2206,1276084,10,24744,22160,24702306,1854,1623914
8/2/2021 0:00,Los Angeles,County,10257557,3692,1279776,15,24759,102597,24804903,4543,1628457
8/3/2021 0:00,Los Angeles,County,10257557,3723,1283499,12,24771,95983,24900886,4792,1633249
8/4/2021 0:00,Los Angeles,County,10257557,3748,1287247,19,24790,116162,25017048,4982,1638231
8/5/2021 0:00,Los Angeles,County,10257557,3493,1290740,23,24813,108948,25125996,4622,1642853
8/6/2021 0:00,Los Angeles,County,10257557,3221,1293961,17,24830,110495,25236491,4655,1647508
8/7/2021 0:00,Los Angeles,County,10257557,2492,1296453,23,24853,49438,25285929,3227,1650735
8/8/2021 0:00,Los Angeles,County,10257557,2037,1298490,19,24872,23166,25309095,1795,1652530
8/9/2021 0:00,Los Angeles,County,10257557,4249,1302739,28,24900,164083,25473178,5205,1657735
8/10/2021 0:00,Los Angeles,County,10257557,4017,1306756,25,24925,138132,25611310,4924,1662659
8/11/2021 0:00,Los Angeles,County,10257557,3759,1310515,14,24939,163430,25774740,5161,1667820
8/12/2021 0:00,Los Angeles,County,10257557,3330,1313845,22,24961,147635,25922375,4832,1672652
8/13/2021 0:00,Los Angeles,County,10257557,3192,1317037,31,24992,136840,26059215,4629,1677281
8/14/2021 0:00,Los Angeles,County,10257557,2326,1319363,28,25020,64553,26123768,3256,1680537
8/15/2021 0:00,Los Angeles,County,10257557,1774,1321137,15,25035,27925,26151693,1778,1682315
8/16/2021 0:00,Los Angeles,County,10257557,3534,1324671,28,25063,178135,26329828,4806,1687121
8/17/2021 0:00,Los Angeles,County,10257557,3384,1328055,30,25093,169533,26499361,4492,1691613
8/18/2021 0:00,Los Angeles,County,10257557,3568,1331623,25,25118,197482,26696843,4634,1696247
8/19/2021 0:00,Los Angeles,County,10257557,3154,1334777,31,25149,190664,26887507,4296,1700543
8/20/2021 0:00,Los Angeles,County,10257557,2984,1337761,24,25173,187919,27075426,4364,1704907
8/21/2021 0:00,Los Angeles,County,10257557,1879,1339640,25,25198,47763,27123189,2574,1707481
8/22/2021 0:00,Los Angeles,County,10257557,1298,1340938,14,25212,26056,27149245,1337,1708818
8/23/2021 0:00,Los Angeles,County,10257557,3322,1344260,33,25245,210931,27360176,4417,1713235
8/24/2021 0:00,Los Angeles,County,10257557,2972,1347232,31,25276,185102,27545278,3851,1717086
8/25/2021 0:00,Los Angeles,County,10257557,2864,1350096,28,25304,210627,27755905,3944,1721030
8/26/2021 0:00,Los Angeles,County,10257557,2601,1352697,30,25334,201498,27957403,3769,1724799
8/27/2021 0:00,Los Angeles,County,10257557,2275,1354972,27,25361,186821,28144224,3372,1728171
8/28/2021 0:00,Los Angeles,County,10257557,1530,1356502,27,25388,43902,28188126,2115,1730286
8/29/2021 0:00,Los Angeles,County,10257557,1216,1357718,31,25419,25818,28213944,1207,1731493
8/30/2021 0:00,Los Angeles,County,10257557,2748,1360466,21,25440,232616,28446560,3717,1735210
8/31/2021 0:00,Los Angeles,County,10257557,2459,1362925,25,25465,205129,28651689,3280,1738490
9/1/2021 0:00,Los Angeles,County,10257557,2595,1365520,31,25496,230429,28882118,3337,1741827
9/2/2021 0:00,Los Angeles,County,10257557,2266,1367786,46,25542,216460,29098578,3154,1744981
9/3/2021 0:00,Los Angeles,County,10257557,1857,1369643,33,25575,90563,29189141,2497,1747478
9/4/2021 0:00,Los Angeles,County,10257557,1332,1370975,28,25603,37303,29226444,1756,1749234
9/5/2021 0:00,Los Angeles,County,10257557,958,1371933,37,25640,23220,29249664,851,1750085
9/6/2021 0:00,Los Angeles,County,10257557,1298,1373231,31,25671,35420,29285084,1429,1751514
9/7/2021 0:00,Los Angeles,County,10257557,2379,1375610,32,25703,161017,29446101,3267,1754781
9/8/2021 0:00,Los Angeles,County,10257557,2230,1377840,25,25728,245884,29691985,2922,1757703
9/9/2021 0:00,Los Angeles,County,10257557,2073,1379913,32,25760,230985,29922970,2827,1760530
9/10/2021 0:00,Los Angeles,County,10257557,1867,1381780,27,25787,193255,30116225,2664,1763194
9/11/2021 0:00,Los Angeles,County,10257557,1206,1382986,24,25811,41392,30157617,1566,1764760
9/12/2021 0:00,Los Angeles,County,10257557,974,1383960,20,25831,24857,30182474,879,1765639
9/13/2021 0:00,Los Angeles,County,10257557,2059,1386019,20,25851,240523,30422997,2771,1768410
9/14/2021 0:00,Los Angeles,County,10257557,1865,1387884,20,25871,211753,30634750,2409,1770819
9/15/2021 0:00,Los Angeles,County,10257557,1836,1389720,19,25890,230471,30865221,2350,1773169
9/16/2021 0:00,Los Angeles,County,10257557,1506,1391226,24,25914,97487,30962708,1970,1775139
9/17/2021 0:00,Los Angeles,County,10257557,1391,1392617,23,25937,183957,31146665,1999,1777138
9/18/2021 0:00,Los Angeles,County,10257557,980,1393597,29,25966,37820,31184485,1267,1778405
9/19/2021 0:00,Los Angeles,County,10257557,763,1394360,16,25982,23996,31208481,715,1779120
9/20/2021 0:00,Los Angeles,County,10257557,1982,1396342,24,26006,210568,31419049,2444,1781564
9/21/2021 0:00,Los Angeles,County,10257557,1523,1397865,25,26031,194058,31613107,2099,1783663
9/22/2021 0:00,Los Angeles,County,10257557,1456,1399321,28,26059,209079,31822186,1950,1785613
9/23/2021 0:00,Los Angeles,County,10257557,1323,1400644,19,26078,210932,32033118,1840,1787453
9/24/2021 0:00,Los Angeles,County,10257557,1197,1401841,24,26102,180012,32213130,1768,1789221
9/25/2021 0:00,Los Angeles,County,10257557,887,1402728,25,26127,35471,32248601,1192,1790413
9/26/2021 0:00,Los Angeles,County,10257557,709,1403437,17,26144,22057,32270658,736,1791149
9/27/2021 0:00,Los Angeles,County,10257557,1490,1404927,18,26162,221754,32492412,1921,1793070
9/28/2021 0:00,Los Angeles,County,10257557,1337,1406264,18,26180,194303,32686715,1683,1794753
9/29/2021 0:00,Los Angeles,County,10257557,1289,1407553,20,26200,217093,32903808,1729,1796482
9/30/2021 0:00,Los Angeles,County,10257557,1223,1408776,12,26212,211166,33114974,1640,1798122
10/1/2021 0:00,Los Angeles,County,10257557,1209,1409985,20,26232,178918,33293892,1611,1799733
10/2/2021 0:00,Los Angeles,County,10257557,765,1410750,26,26258,33102,33326994,949,1800682
10/3/2021 0:00,Los Angeles,County,10257557,612,1411362,15,26273,21585,33348579,593,1801275
10/4/2021 0:00,Los Angeles,County,10257557,1260,1412622,16,26289,216621,33565200,1671,1802946
10/5/2021 0:00,Los Angeles,County,10257557,1121,1413743,22,26311,179111,33744311,1525,1804471
10/6/2021 0:00,Los Angeles,County,10257557,1143,1414886,17,26328,204693,33949004,1497,1805968
10/7/2021 0:00,Los Angeles,County,10257557,957,1415843,20,26348,195564,34144568,1381,1807349
10/8/2021 0:00,Los Angeles,County,10257557,956,1416799,20,26368,178315,34322883,1415,1808764
10/9/2021 0:00,Los Angeles,County,10257557,661,1417460,7,26375,31954,34354837,916,1809680
10/10/2021 0:00,Los Angeles,County,10257557,586,1418046,9,26384,21873,34376710,530,1810210
10/11/2021 0:00,Los Angeles,County,10257557,1188,1419234,13,26397,212997,34589707,1515,1811725
10/12/2021 0:00,Los Angeles,County,10257557,1046,1420280,17,26414,199562,34789269,1395,1813120
10/13/2021 0:00,Los Angeles,County,10257557,1060,1421340,12,26426,202068,34991337,1433,1814553
10/14/2021 0:00,Los Angeles,County,10257557,1057,1422397,15,26441,203918,35195255,1416,1815969
10/15/2021 0:00,Los Angeles,County,10257557,986,1423383,11,26452,178206,35373461,1370,1817339
10/16/2021 0:00,Los Angeles,County,10257557,686,1424069,23,26475,32240,35405701,803,1818142
10/17/2021 0:00,Los Angeles,County,10257557,653,1424722,15,26490,22077,35427778,573,1818715
10/18/2021 0:00,Los Angeles,County,10257557,1336,1426058,11,26501,217765,35645543,1651,1820366
10/19/2021 0:00,Los Angeles,County,10257557,1243,1427301,9,26510,193837,35839380,1420,1821786
10/20/2021 0:00,Los Angeles,County,10257557,1247,1428548,10,26520,215254,36054634,1562,1823348
10/21/2021 0:00,Los Angeles,County,10257557,1118,1429666,15,26535,208993,36263627,1500,1824848
10/22/2021 0:00,Los Angeles,County,10257557,1121,1430787,13,26548,171373,36435000,1485,1826333
10/23/2021 0:00,Los Angeles,County,10257557,765,1431552,13,26561,30928,36465928,918,1827251
10/24/2021 0:00,Los Angeles,County,10257557,676,1432228,13,26574,20067,36485995,643,1827894
10/25/2021 0:00,Los Angeles,County,10257557,1434,1433662,12,26586,197768,36683763,1755,1829649
10/26/2021 0:00,Los Angeles,County,10257557,1355,1435017,13,26599,201028,36884791,1732,1831381
10/27/2021 0:00,Los Angeles,County,10257557,1339,1436356,12,26611,213726,37098517,1771,1833152
10/28/2021 0:00,Los Angeles,County,10257557,1229,1437585,15,26626,204003,37302520,1594,1834746
10/29/2021 0:00,Los Angeles,County,10257557,1137,1438722,11,26637,155692,37458212,1574,1836320
10/30/2021 0:00,Los Angeles,County,10257557,841,1439563,14,26651,31573,37489785,1080,1837400
10/31/2021 0:00,Los Angeles,County,10257557,722,1440285,12,26663,20252,37510037,661,1838061
11/1/2021 0:00,Los Angeles,County,10257557,1552,1441837,14,26677,214029,37724066,1893,1839954
11/2/2021 0:00,Los Angeles,County,10257557,1386,1443223,14,26691,193583,37917649,1670,1841624
11/3/2021 0:00,Los Angeles,County,10257557,1442,1444665,11,26702,217525,38135174,1883,1843507
11/4/2021 0:00,Los Angeles,County,10257557,1352,1446017,16,26718,208341,38343515,1803,1845310
11/5/2021 0:00,Los Angeles,County,10257557,1306,1447323,16,26734,183129,38526644,1739,1847049
11/6/2021 0:00,Los Angeles,County,10257557,823,1448146,12,26746,34391,38561035,1022,1848071
11/7/2021 0:00,Los Angeles,County,10257557,771,1448917,14,26760,133421,38694456,788,1848859
11/8/2021 0:00,Los Angeles,County,10257557,1488,1450405,11,26771,219661,38914117,1944,1850803
11/9/2021 0:00,Los Angeles,County,10257557,1338,1451743,19,26790,237546,39151663,1752,1852555
11/10/2021 0:00,Los Angeles,County,10257557,1253,1452996,20,26810,136865,39288528,1708,1854263
11/11/2021 0:00,Los Angeles,County,10257557,951,1453947,16,26826,170485,39459013,1310,1855573
11/12/2021 0:00,Los Angeles,County,10257557,1096,1455043,13,26839,94431,39553444,1579,1857152
11/13/2021 0:00,Los Angeles,County,10257557,728,1455771,12,26851,31719,39585163,974,1858126
11/14/2021 0:00,Los Angeles,County,10257557,654,1456425,15,26866,122125,39707288,688,1858814
11/15/2021 0:00,Los Angeles,County,10257557,1364,1457789,21,26887,203289,39910577,1769,1860583
11/16/2021 0:00,Los Angeles,County,10257557,1189,1458978,8,26895,226246,40136823,1500,1862083
11/17/2021 0:00,Los Angeles,County,10257557,1169,1460147,12,26907,213579,40350402,1629,1863712
11/18/2021 0:00,Los Angeles,County,10257557,1097,1461244,11,26918,189049,40539451,1541,1865253
11/19/2021 0:00,Los Angeles,County,10257557,988,1462232,11,26929,81242,40620693,1421,1866674
11/20/2021 0:00,Los Angeles,County,10257557,688,1462920,10,26939,29579,40650272,900,1867574
11/21/2021 0:00,Los Angeles,County,10257557,620,1463540,12,26951,29871,40680143,619,1868193
11/22/2021 0:00,Los Angeles,County,10257557,1059,1464599,12,26963,101717,40781860,1421,1869614
11/23/2021 0:00,Los Angeles,County,10257557,1065,1465664,26,26989,81465,40863325,1423,1871037
11/24/2021 0:00,Los Angeles,County,10257557,1008,1466672,13,27002,58436,40921761,1404,1872441
11/25/2021 0:00,Los Angeles,County,10257557,485,1467157,15,27017,8562,40930323,266,1872707
11/26/2021 0:00,Los Angeles,County,10257557,970,1468127,12,27029,39704,40970027,1224,1873931
11/27/2021 0:00,Los Angeles,County,10257557,849,1468976,11,27040,34981,41005008,1043,1874974
11/28/2021 0:00,Los Angeles,County,10257557,1007,1469983,15,27055,130294,41135302,739,1875713
11/29/2021 0:00,Los Angeles,County,10257557,2166,1472149,20,27075,241160,41376462,2492,1878205
11/30/2021 0:00,Los Angeles,County,10257557,1848,1473997,17,27092,234611,41611073,2195,1880400
12/1/2021 0:00,Los Angeles,County,10257557,1797,1475794,20,27112,220738,41831811,2137,1882537
12/2/2021 0:00,Los Angeles,County,10257557,1591,1477385,15,27127,197415,42029226,2137,1884674
12/3/2021 0:00,Los Angeles,County,10257557,1519,1478904,13,27140,88910,42118136,2014,1886688
12/4/2021 0:00,Los Angeles,County,10257557,946,1479850,9,27149,36422,42154558,1208,1887896
12/5/2021 0:00,Los Angeles,County,10257557,877,1480727,11,27160,126012,42280570,872,1888768
12/6/2021 0:00,Los Angeles,County,10257557,1846,1482573,9,27169,206746,42487316,2396,1891164
12/7/2021 0:00,Los Angeles,County,10257557,1662,1484235,14,27183,234230,42721546,2116,1893280
12/8/2021 0:00,Los Angeles,County,10257557,1777,1486012,10,27193,217873,42939419,2266,1895546
12/9/2021 0:00,Los Angeles,County,10257557,1547,1487559,15,27208,190346,43129765,2045,1897591
12/10/2021 0:00,Los Angeles,County,10257557,1541,1489100,8,27216,89219,43218984,2036,1899627
12/11/2021 0:00,Los Angeles,County,10257557,1089,1490189,20,27236,37381,43256365,1397,1901024
12/12/2021 0:00,Los Angeles,County,10257557,1214,1491403,12,27248,90768,43347133,974,1901998
12/13/2021 0:00,Los Angeles,County,10257557,2916,1494319,15,27263,180177,43527310,2825,1904823
12/14/2021 0:00,Los Angeles,County,10257557,2785,1497104,10,27273,176032,43703342,2635,1907458
12/15/2021 0:00,Los Angeles,County,10257557,3672,1500776,19,27292,222587,43925929,4263,1911721
12/16/2021 0:00,Los Angeles,County,10257557,3909,1504685,15,27307,199335,44125264,4663,1916384
12/17/2021 0:00,Los Angeles,County,10257557,4214,1508899,18,27325,167586,44292850,4871,1921255
12/18/2021 0:00,Los Angeles,County,10257557,3946,1512845,13,27338,51033,44343883,4175,1925430
12/19/2021 0:00,Los Angeles,County,10257557,4099,1516944,19,27357,40342,44384225,3481,1928911
12/20/2021 0:00,Los Angeles,County,10257557,9012,1525956,13,27370,128672,44512897,9550,1938461
12/21/2021 0:00,Los Angeles,County,10257557,11498,1537454,13,27383,134581,44647478,13099,1951560
12/22/2021 0:00,Los Angeles,County,10257557,13909,1551363,14,27397,149487,44796965,16470,1968030
12/23/2021 0:00,Los Angeles,County,10257557,13561,1564924,21,27418,124077,44921042,16340,1984370
12/24/2021 0:00,Los Angeles,County,10257557,9567,1574491,13,27431,65862,44986904,10116,1994486
12/25/2021 0:00,Los Angeles,County,10257557,4878,1579369,16,27447,17214,45004118,3476,1997962
12/26/2021 0:00,Los Angeles,County,10257557,12826,1592195,14,27461,64555,45068673,12561,2010523
12/27/2021 0:00,Los Angeles,County,10257557,29913,1622108,24,27485,161961,45230634,32684,2043207
12/28/2021 0:00,Los Angeles,County,10257557,36369,1658477,19,27504,187869,45418503,41444,2084651
12/29/2021 0:00,Los Angeles,County,10257557,32297,1690774,18,27522,178788,45597291,39662,2124313
12/30/2021 0:00,Los Angeles,County,10257557,30021,1720795,16,27538,165168,45762459,36398,2160711
12/31/2021 0:00,Los Angeles,County,10257557,23322,1744117,19,27557,113898,45876357,27189,2187900
1/1/2022 0:00,Los Angeles,County,10257557,10788,1754905,23,27580,40389,45916746,10425,2198325
1/2/2022 0:00,Los Angeles,County,10257557,20159,1775064,18,27598,101329,46018075,22925,2221250
1/3/2022 0:00,Los Angeles,County,10257557,51231,1826295,36,27634,300605,46318680,60839,2282089
1/4/2022 0:00,Los Angeles,County,10257557,60881,1887176,28,27662,339130,46657810,71217,2353306
1/5/2022 0:00,Los Angeles,County,10257557,59996,1947172,42,27704,338717,46996527,70330,2423636
1/6/2022 0:00,Los Angeles,County,10257557,56355,2003527,38,27742,343996,47340523,66642,2490278
1/7/2022 0:00,Los Angeles,County,10257557,54192,2057719,36,27778,325060,47665583,66887,2557165
1/8/2022 0:00,Los Angeles,County,10257557,31200,2088919,48,27826,162142,47827725,38296,2595461
1/9/2022 0:00,Los Angeles,County,10257557,18406,2107325,39,27865,90273,47917998,22094,2617555
1/10/2022 0:00,Los Angeles,County,10257557,48099,2155424,39,27904,315835,48233833,61374,2678929
1/11/2022 0:00,Los Angeles,County,10257557,45590,2201014,63,27967,340509,48574342,57533,2736462
1/12/2022 0:00,Los Angeles,County,10257557,42521,2243535,70,28037,329956,48904298,53700,2790162
1/13/2022 0:00,Los Angeles,County,10257557,39775,2283310,69,28106,322579,49226877,51018,2841180
1/14/2022 0:00,Los Angeles,County,10257557,36516,2319826,66,28172,298238,49525115,48106,2889286
1/15/2022 0:00,Los Angeles,County,10257557,19332,2339158,93,28265,104572,49629687,25733,2915019
1/16/2022 0:00,Los Angeles,County,10257557,11552,2350710,69,28334,64515,49694202,14099,2929118
1/17/2022 0:00,Los Angeles,County,10257557,23220,2373930,75,28409,150061,49844263,29768,2958886
1/18/2022 0:00,Los Angeles,County,10257557,39245,2413175,80,28489,365645,50209908,50870,3009756
1/19/2022 0:00,Los Angeles,County,10257557,33454,2446629,96,28585,315839,50525747,43897,3053653
1/20/2022 0:00,Los Angeles,County,10257557,28406,2475035,78,28663,295067,50820814,38155,3091808
1/21/2022 0:00,Los Angeles,County,10257557,24744,2499779,91,28754,263256,51084070,34752,3126560
1/22/2022 0:00,Los Angeles,County,10257557,11309,2511088,89,28843,78859,51162929,16416,3142976
1/23/2022 0:00,Los Angeles,County,10257557,7428,2518516,99,28942,52007,51214936,10205,3153181
1/24/2022 0:00,Los Angeles,County,10257557,20342,2538858,78,29020,288550,51503486,29275,3182456
1/25/2022 0:00,Los Angeles,County,10257557,16535,2555393,85,29105,254557,51758043,24250,3206706
1/26/2022 0:00,Los Angeles,County,10257557,14955,2570348,90,29195,248634,52006677,21947,3228653
1/27/2022 0:00,Los Angeles,County,10257557,12212,2582560,83,29278,229004,52235681,18006,3246659
1/28/2022 0:00,Los Angeles,County,10257557,11160,2593720,86,29364,207564,52443245,17355,3264014
1/29/2022 0:00,Los Angeles,County,10257557,5728,2599448,90,29454,59447,52502692,9223,3273237
1/30/2022 0:00,Los Angeles,County,10257557,3907,2603355,107,29561,39496,52542188,5245,3278482
1/31/2022 0:00,Los Angeles,County,10257557,10085,2613440,99,29660,264141,52806329,15783,3294265
2/1/2022 0:00,Los Angeles,County,10257557,8232,2621672,113,29773,217701,53024030,12144,3306409
2/2/2022 0:00,Los Angeles,County,10257557,7159,2628831,108,29881,219078,53243108,10814,3317223
2/3/2022 0:00,Los Angeles,County,10257557,6223,2635054,89,29970,215562,53458670,9615,3326838
2/4/2022 0:00,Los Angeles,County,10257557,5421,2640475,93,30063,183968,53642638,8940,3335778
2/5/2022 0:00,Los Angeles,County,10257557,2637,2643112,79,30142,42642,53685280,4490,3340268
2/6/2022 0:00,Los Angeles,County,10257557,2175,2645287,70,30212,31888,53717168,2957,3343225
2/7/2022 0:00,Los Angeles,County,10257557,5505,2650792,86,30298,240627,53957795,8482,3351707
2/8/2022 0:00,Los Angeles,County,10257557,4429,2655221,93,30391,205665,54163460,6610,3358317
2/9/2022 0:00,Los Angeles,County,10257557,4308,2659529,82,30473,207645,54371105,6270,3364587
2/10/2022 0:00,Los Angeles,County,10257557,3633,2663162,69,30542,200953,54572058,5520,3370107
2/11/2022 0:00,Los Angeles,County,10257557,3137,2666299,77,30619,162675,54734733,4797,3374904
2/12/2022 0:00,Los Angeles,County,10257557,1631,2667930,55,30674,35730,54770463,2652,3377556
2/13/2022 0:00,Los Angeles,County,10257557,1155,2669085,55,30729,24389,54794852,1686,3379242
2/14/2022 0:00,Los Angeles,County,10257557,3151,2672236,58,30787,215343,55010195,4773,3384015
2/15/2022 0:00,Los Angeles,County,10257557,2561,2674797,39,30826,192216,55202411,3871,3387886
2/16/2022 0:00,Los Angeles,County,10257557,2255,2677052,67,30893,187599,55390010,3399,3391285
2/17/2022 0:00,Los Angeles,County,10257557,2078,2679130,52,30945,187992,55578002,3158,3394443
2/18/2022 0:00,Los Angeles,County,10257557,1822,2680952,46,30991,152837,55730839,2817,3397260
2/19/2022 0:00,Los Angeles,County,10257557,984,2681936,31,31022,26400,55757239,1516,3398776
2/20/2022 0:00,Los Angeles,County,10257557,788,2682724,50,31072,23362,55780601,1119,3399895
2/21/2022 0:00,Los Angeles,County,10257557,1322,2684046,38,31110,61805,55842406,1959,3401854
2/22/2022 0:00,Los Angeles,County,10257557,1774,2685820,42,31152,248926,56091332,2814,3404668
2/23/2022 0:00,Los Angeles,County,10257557,1459,2687279,29,31181,202445,56293777,2239,3406907
2/24/2022 0:00,Los Angeles,County,10257557,1361,2688640,27,31208,194074,56487851,2058,3408965
2/25/2022 0:00,Los Angeles,County,10257557,1157,2689797,35,31243,167489,56655340,1793,3410758
2/26/2022 0:00,Los Angeles,County,10257557,588,2690385,30,31273,28286,56683626,959,3411717
2/27/2022 0:00,Los Angeles,County,10257557,571,2690956,23,31296,23026,56706652,723,3412440
2/28/2022 0:00,Los Angeles,County,10257557,1309,2692265,35,31331,193055,56899707,1868,3414308
3/1/2022 0:00,Los Angeles,County,10257557,1165,2693430,33,31364,170337,57070044,1668,3415976
3/2/2022 0:00,Los Angeles,County,10257557,950,2694380,20,31384,170569,57240613,1385,3417361
3/3/2022 0:00,Los Angeles,County,10257557,878,2695258,24,31408,167510,57408123,1306,3418667
3/4/2022 0:00,Los Angeles,County,10257557,725,2695983,21,31429,139209,57547332,1188,3419855
3/5/2022 0:00,Los Angeles,County,10257557,530,2696513,27,31456,25665,57572997,695,3420550
3/6/2022 0:00,Los Angeles,County,10257557,364,2696877,20,31476,20854,57593851,456,3421006
3/7/2022 0:00,Los Angeles,County,10257557,924,2697801,26,31502,181917,57775768,1318,3422324
3/8/2022 0:00,Los Angeles,County,10257557,798,2698599,18,31520,161042,57936810,1165,3423489
3/9/2022 0:00,Los Angeles,County,10257557,692,2699291,18,31538,165618,58102428,1014,3424503
3/10/2022 0:00,Los Angeles,County,10257557,645,2699936,24,31562,161988,58264416,904,3425407
3/11/2022 0:00,Los Angeles,County,10257557,554,2700490,21,31583,135449,58399865,874,3426281
3/12/2022 0:00,Los Angeles,County,10257557,321,2700811,19,31602,22508,58422373,453,3426734
3/13/2022 0:00,Los Angeles,County,10257557,326,2701137,9,31611,19510,58441883,394,3427128
3/14/2022 0:00,Los Angeles,County,10257557,725,2701862,6,31617,179527,58621410,987,3428115
3/15/2022 0:00,Los Angeles,County,10257557,631,2702493,11,31628,161367,58782777,877,3428992
3/16/2022 0:00,Los Angeles,County,10257557,688,2703181,10,31638,160984,58943761,884,3429876
3/17/2022 0:00,Los Angeles,County,10257557,631,2703812,15,31653,151947,59095708,826,3430702
3/18/2022 0:00,Los Angeles,County,10257557,658,2704470,10,31663,132526,59228234,836,3431538
3/19/2022 0:00,Los Angeles,County,10257557,353,2704823,8,31671,21809,59250043,452,3431990
3/20/2022 0:00,Los Angeles,County,10257557,377,2705200,13,31684,18910,59268953,398,3432388
3/21/2022 0:00,Los Angeles,County,10257557,792,2705992,9,31693,175308,59444261,992,3433380
3/22/2022 0:00,Los Angeles,County,10257557,858,2706850,8,31701,145931,59590192,1077,3434457
3/23/2022 0:00,Los Angeles,County,10257557,667,2707517,7,31708,148458,59738650,920,3435377
3/24/2022 0:00,Los Angeles,County,10257557,680,2708197,3,31711,151567,59890217,950,3436327
3/25/2022 0:00,Los Angeles,County,10257557,573,2708770,15,31726,128406,60018623,827,3437154
3/26/2022 0:00,Los Angeles,County,10257557,424,2709194,6,31732,20963,60039586,506,3437660
3/27/2022 0:00,Los Angeles,County,10257557,456,2709650,6,31738,17192,60056778,464,3438124
3/28/2022 0:00,Los Angeles,County,10257557,817,2710467,8,31746,91318,60148096,1009,3439133
3/29/2022 0:00,Los Angeles,County,10257557,869,2711336,10,31756,167732,60315828,1178,3440311
3/30/2022 0:00,Los Angeles,County,10257557,830,2712166,4,31760,161792,60477620,1070,3441381
3/31/2022 0:00,Los Angeles,County,10257557,816,2712982,7,31767,146026,60623646,1066,3442447
4/1/2022 0:00,Los Angeles,County,10257557,741,2713723,11,31778,131011,60754657,994,3443441
4/2/2022 0:00,Los Angeles,County,10257557,494,2714217,6,31784,19702,60774359,580,3444021
4/3/2022 0:00,Los Angeles,County,10257557,520,2714737,2,31786,16442,60790801,557,3444578
4/4/2022 0:00,Los Angeles,County,10257557,1190,2715927,7,31793,160652,60951453,1416,3445994
4/5/2022 0:00,Los Angeles,County,10257557,1095,2717022,5,31798,136000,61087453,1412,3447406
4/6/2022 0:00,Los Angeles,County,10257557,1054,2718076,12,31810,147859,61235312,1342,3448748
4/7/2022 0:00,Los Angeles,County,10257557,1045,2719121,9,31819,146688,61382000,1303,3450051
4/8/2022 0:00,Los Angeles,County,10257557,908,2720029,3,31822,126430,61508430,1170,3451221
4/9/2022 0:00,Los Angeles,County,10257557,627,2720656,5,31827,19397,61527827,777,3451998
4/10/2022 0:00,Los Angeles,County,10257557,685,2721341,5,31832,17317,61545144,608,3452606
4/11/2022 0:00,Los Angeles,County,10257557,1324,2722665,7,31839,81977,61627121,1526,3454132
4/12/2022 0:00,Los Angeles,County,10257557,1253,2723918,6,31845,71329,61698450,1466,3455598
4/13/2022 0:00,Los Angeles,County,10257557,1241,2725159,4,31849,71992,61770442,1530,3457128
4/14/2022 0:00,Los Angeles,County,10257557,1261,2726420,8,31857,62201,61832643,1559,3458687
4/15/2022 0:00,Los Angeles,County,10257557,1086,2727506,8,31865,48874,61881517,1310,3459997
4/16/2022 0:00,Los Angeles,County,10257557,778,2728284,6,31871,20485,61902002,949,3460946
4/17/2022 0:00,Los Angeles,County,10257557,717,2729001,4,31875,12687,61914689,568,3461514
4/18/2022 0:00,Los Angeles,County,10257557,1983,2730984,1,31876,181637,62096326,2380,3463894
4/19/2022 0:00,Los Angeles,County,10257557,1826,2732810,4,31880,161792,62258118,2257,3466151
4/20/2022 0:00,Los Angeles,County,10257557,1793,2734603,7,31887,168852,62426970,2159,3468310
4/21/2022 0:00,Los Angeles,County,10257557,1739,2736342,1,31888,167061,62594031,2203,3470513
4/22/2022 0:00,Los Angeles,County,10257557,1647,2737989,4,31892,144699,62738730,2090,3472603
4/23/2022 0:00,Los Angeles,County,10257557,1080,2739069,2,31894,21799,62760529,1333,3473936
4/24/2022 0:00,Los Angeles,County,10257557,946,2740015,7,31901,17984,62778513,1021,3474957
4/25/2022 0:00,Los Angeles,County,10257557,2342,2742357,5,31906,202718,62981231,2790,3477747
4/26/2022 0:00,Los Angeles,County,10257557,2380,2744737,3,31909,177845,63159076,2932,3480679
4/27/2022 0:00,Los Angeles,County,10257557,2380,2747117,6,31915,182418,63341494,2847,3483526
4/28/2022 0:00,Los Angeles,County,10257557,2311,2749428,2,31917,175759,63517253,2924,3486450
4/29/2022 0:00,Los Angeles,County,10257557,2058,2751486,6,31923,149224,63666477,2613,3489063
4/30/2022 0:00,Los Angeles,County,10257557,1295,2752781,1,31924,20647,63687124,1634,3490697
5/1/2022 0:00,Los Angeles,County,10257557,1382,2754163,3,31927,17842,63704966,1402,3492099
5/2/2022 0:00,Los Angeles,County,10257557,3008,2757171,3,31930,193870,63898836,3505,3495604
5/3/2022 0:00,Los Angeles,County,10257557,3025,2760196,5,31935,173741,64072577,3539,3499143
5/4/2022 0:00,Los Angeles,County,10257557,3059,2763255,2,31937,181345,64253922,3685,3502828
5/5/2022 0:00,Los Angeles,County,10257557,2781,2766036,2,31939,176219,64430141,3326,3506154
5/6/2022 0:00,Los Angeles,County,10257557,2578,2768614,6,31945,152033,64582174,3165,3509319
5/7/2022 0:00,Los Angeles,County,10257557,1817,2770431,6,31951,22974,64605148,2185,3511504
5/8/2022 0:00,Los Angeles,County,10257557,1578,2772009,5,31956,17768,64622916,1593,3513097
5/9/2022 0:00,Los Angeles,County,10257557,3590,2775599,3,31959,202950,64825866,4354,3517451
5/10/2022 0:00,Los Angeles,County,10257557,3349,2778948,9,31968,174658,65000524,4225,3521676
5/11/2022 0:00,Los Angeles,County,10257557,3287,2782235,5,31973,184487,65185011,4161,3525837
5/12/2022 0:00,Los Angeles,County,10257557,3116,2785351,2,31975,176206,65361217,4042,3529879
5/13/2022 0:00,Los Angeles,County,10257557,3207,2788558,6,31981,158685,65519902,3982,3533861
5/14/2022 0:00,Los Angeles,County,10257557,1942,2790500,7,31988,22225,65542127,2319,3536180
5/15/2022 0:00,Los Angeles,County,10257557,1932,2792432,6,31994,19187,65561314,2032,3538212
5/16/2022 0:00,Los Angeles,County,10257557,4588,2797020,3,31997,202682,65763996,5636,3543848
5/17/2022 0:00,Los Angeles,County,10257557,4421,2801441,7,32004,173500,65937496,5296,3549144
5/18/2022 0:00,Los Angeles,County,10257557,4524,2805965,3,32007,185434,66122930,5472,3554616
5/19/2022 0:00,Los Angeles,County,10257557,4323,2810288,4,32011,180465,66303395,5343,3559959
5/20/2022 0:00,Los Angeles,County,10257557,3962,2814250,2,32013,157428,66460823,5028,3564987
5/21/2022 0:00,Los Angeles,County,10257557,2362,2816612,7,32020,23161,66483984,2947,3567934
5/22/2022 0:00,Los Angeles,County,10257557,2315,2818927,3,32023,20365,66504349,2655,3570589
5/23/2022 0:00,Los Angeles,County,10257557,5842,2824769,5,32028,206153,66710502,6935,3577524
5/24/2022 0:00,Los Angeles,County,10257557,5408,2830177,11,32039,177507,66888009,6415,3583939
5/25/2022 0:00,Los Angeles,County,10257557,5270,2835447,5,32044,184928,67072937,6482,3590421
5/26/2022 0:00,Los Angeles,County,10257557,4627,2840074,4,32048,175958,67248895,5916,3596337
5/27/2022 0:00,Los Angeles,County,10257557,4170,2844244,3,32051,144933,67393828,5520,3601857
5/28/2022 0:00,Los Angeles,County,10257557,2350,2846594,9,32060,20117,67413945,2937,3604794
5/29/2022 0:00,Los Angeles,County,10257557,1981,2848575,6,32066,17029,67430974,2217,3607011
5/30/2022 0:00,Los Angeles,County,10257557,2241,2850816,9,32075,26324,67457298,2151,3609162
5/31/2022 0:00,Los Angeles,County,10257557,7296,2858112,6,32081,247350,67704648,9324,3618486
6/1/2022 0:00,Los Angeles,County,10257557,6071,2864183,6,32087,207743,67912391,7256,3625742
6/2/2022 0:00,Los Angeles,County,10257557,5395,2869578,4,32091,194739,68107130,6724,3632466
6/3/2022 0:00,Los Angeles,County,10257557,4920,2874498,6,32097,166299,68273429,6331,3638797
6/4/2022 0:00,Los Angeles,County,10257557,2905,2877403,5,32102,24977,68298406,3539,3642336
6/5/2022 0:00,Los Angeles,County,10257557,2457,2879860,8,32110,19590,68317996,2782,3645118
6/6/2022 0:00,Los Angeles,County,10257557,6065,2885925,4,32114,181038,68499034,7589,3652707
6/7/2022 0:00,Los Angeles,County,10257557,5632,2891557,8,32122,157861,68656895,7007,3659714
6/8/2022 0:00,Los Angeles,County,10257557,5318,2896875,6,32128,152768,68809663,6794,3666508
6/9/2022 0:00,Los Angeles,County,10257557,4616,2901491,8,32136,129564,68939227,5870,3672378
6/10/2022 0:00,Los Angeles,County,10257557,4402,2905893,5,32141,97713,69036940,5660,3678038
6/11/2022 0:00,Los Angeles,County,10257557,2729,2908622,10,32151,22625,69059565,3408,3681446
6/12/2022 0:00,Los Angeles,County,10257557,2350,2910972,10,32161,20092,69079657,2683,3684129
6/13/2022 0:00,Los Angeles,County,10257557,4951,2915923,7,32168,79883,69159540,6392,3690521
6/14/2022 0:00,Los Angeles,County,10257557,4573,2920496,7,32175,73240,69232780,5773,3696294
6/15/2022 0:00,Los Angeles,County,10257557,4523,2925019,6,32181,63305,69296085,5781,3702075
6/16/2022 0:00,Los Angeles,County,10257557,4289,2929308,11,32192,59779,69355864,5507,3707582
6/17/2022 0:00,Los Angeles,County,10257557,3989,2933297,12,32204,52429,69408293,5283,3712865
6/18/2022 0:00,Los Angeles,County,10257557,2846,2936143,9,32213,22005,69430298,3620,3716485
6/19/2022 0:00,Los Angeles,County,10257557,2444,2938587,5,32218,17771,69448069,2771,3719256
6/20/2022 0:00,Los Angeles,County,10257557,4866,2943453,8,32226,62964,69511033,6132,3725388
6/21/2022 0:00,Los Angeles,County,10257557,5410,2948863,12,32238,75232,69586265,6969,3732357
6/22/2022 0:00,Los Angeles,County,10257557,4824,2953687,9,32247,62392,69648657,5934,3738291
6/23/2022 0:00,Los Angeles,County,10257557,4965,2958652,10,32257,60142,69708799,6434,3744725
6/24/2022 0:00,Los Angeles,County,10257557,4670,2963322,13,32270,50879,69759678,6001,3750726
6/25/2022 0:00,Los Angeles,County,10257557,3287,2966609,6,32276,22647,69782325,4138,3754864
6/26/2022 0:00,Los Angeles,County,10257557,3016,2969625,14,32290,19699,69802024,3311,3758175
6/27/2022 0:00,Los Angeles,County,10257557,6593,2976218,9,32299,73362,69875386,8038,3766213
6/28/2022 0:00,Los Angeles,County,10257557,6203,2982421,10,32309,66587,69941973,7618,3773831
6/29/2022 0:00,Los Angeles,County,10257557,5943,2988364,8,32317,60546,70002519,7479,3781310
6/30/2022 0:00,Los Angeles,County,10257557,5641,2994005,9,32326,59168,70061687,7051,3788361
7/1/2022 0:00,Los Angeles,County,10257557,5408,2999413,11,32337,46518,70108205,7005,3795366
7/2/2022 0:00,Los Angeles,County,10257557,3487,3002900,19,32356,20242,70128447,4387,3799753
7/3/2022 0:00,Los Angeles,County,10257557,2762,3005662,16,32372,14559,70143006,2822,3802575
7/4/2022 0:00,Los Angeles,County,10257557,2823,3008485,15,32387,18364,70161370,2251,3804826
7/5/2022 0:00,Los Angeles,County,10257557,8492,3016977,8,32395,85977,70247347,10569,3815395
7/6/2022 0:00,Los Angeles,County,10257557,6937,3023914,11,32406,63567,70310914,8752,3824147
7/7/2022 0:00,Los Angeles,County,10257557,6456,3030370,15,32421,61461,70372375,8293,3832440
7/8/2022 0:00,Los Angeles,County,10257557,6342,3036712,17,32438,53296,70425671,8083,3840523
7/9/2022 0:00,Los Angeles,County,10257557,4282,3040994,13,32451,24531,70450202,5390,3845913
7/10/2022 0:00,Los Angeles,County,10257557,3505,3044499,12,32463,19860,70470062,4123,3850036
7/11/2022 0:00,Los Angeles,County,10257557,7316,3051815,15,32478,72525,70542587,9496,3859532
7/12/2022 0:00,Los Angeles,County,10257557,7155,3058970,21,32499,65741,70608328,9111,3868643
7/13/2022 0:00,Los Angeles,County,10257557,6818,3065788,12,32511,59908,70668236,8452,3877095
7/14/2022 0:00,Los Angeles,County,10257557,6687,3072475,6,32517,57993,70726229,8207,3885302
7/15/2022 0:00,Los Angeles,County,10257557,6199,3078674,16,32533,50906,70777135,7938,3893240
7/16/2022 0:00,Los Angeles,County,10257557,4198,3082872,12,32545,24954,70802089,5356,3898596
7/17/2022 0:00,Los Angeles,County,10257557,3477,3086349,30,32575,19788,70821877,4098,3902694
7/18/2022 0:00,Los Angeles,County,10257557,7321,3093670,15,32590,72906,70894783,9479,3912173
7/19/2022 0:00,Los Angeles,County,10257557,6844,3100514,16,32606,65868,70960651,8719,3920892
7/20/2022 0:00,Los Angeles,County,10257557,6176,3106690,16,32622,59567,71020218,7944,3928836
7/21/2022 0:00,Los Angeles,County,10257557,5614,3112304,16,32638,54638,71074856,7289,3936125
7/22/2022 0:00,Los Angeles,County,10257557,5623,3117927,21,32659,45850,71120706,7403,3943528
7/23/2022 0:00,Los Angeles,County,10257557,3539,3121466,14,32673,22925,71143631,4730,3948258
7/24/2022 0:00,Los Angeles,County,10257557,2847,3124313,17,32690,18586,71162217,3620,3951878
7/25/2022 0:00,Los Angeles,County,10257557,6494,3130807,22,32712,66756,71228973,8403,3960281
7/26/2022 0:00,Los Angeles,County,10257557,5857,3136664,19,32731,58965,71287938,7528,3967809
7/27/2022 0:00,Los Angeles,County,10257557,5035,3141699,20,32751,54326,71342264,6587,3974396
7/28/2022 0:00,Los Angeles,County,10257557,4779,3146478,23,32774,52036,71394300,6246,3980642
7/29/2022 0:00,Los Angeles,County,10257557,4328,3150806,16,32790,43575,71437875,5982,3986624
7/30/2022 0:00,Los Angeles,County,10257557,2867,3153673,18,32808,20551,71458426,3858,3990482
7/31/2022 0:00,Los Angeles,County,10257557,2484,3156157,14,32822,16508,71474934,3036,3993518
8/1/2022 0:00,Los Angeles,County,10257557,5260,3161417,21,32843,63017,71537951,6611,4000129
8/2/2022 0:00,Los Angeles,County,10257557,4759,3166176,18,32861,55919,71593870,5961,4006090
8/3/2022 0:00,Los Angeles,County,10257557,4374,3170550,28,32889,52087,71645957,5576,4011666
8/4/2022 0:00,Los Angeles,County,10257557,3753,3174303,18,32907,46276,71692233,4887,4016553
8/5/2022 0:00,Los Angeles,County,10257557,3725,3178028,27,32934,42455,71734688,5109,4021662
8/6/2022 0:00,Los Angeles,County,10257557,2512,3180540,14,32948,18394,71753082,3196,4024858
8/7/2022 0:00,Los Angeles,County,10257557,2206,3182746,8,32956,15482,71768564,2622,4027480
8/8/2022 0:00,Los Angeles,County,10257557,4469,3187215,17,32973,62820,71831384,5919,4033399
8/9/2022 0:00,Los Angeles,County,10257557,3663,3190878,17,32990,53767,71885151,5042,4038441
8/10/2022 0:00,Los Angeles,County,10257557,3513,3194391,18,33008,50665,71935816,4691,4043132
8/11/2022 0:00,Los Angeles,County,10257557,3222,3197613,13,33021,50209,71986025,4281,4047413
8/12/2022 0:00,Los Angeles,County,10257557,3018,3200631,20,33041,42316,72028341,4128,4051541
8/13/2022 0:00,Los Angeles,County,10257557,2097,3202728,12,33053,17644,72045985,2818,4054359
8/14/2022 0:00,Los Angeles,County,10257557,1862,3204590,16,33069,14615,72060600,2244,4056603
8/15/2022 0:00,Los Angeles,County,10257557,3579,3208169,14,33083,60371,72120971,4520,4061123
8/16/2022 0:00,Los Angeles,County,10257557,3425,3211594,21,33104,51925,72172896,4361,4065484
8/17/2022 0:00,Los Angeles,County,10257557,3086,3214680,16,33120,46927,72219823,3942,4069426
8/18/2022 0:00,Los Angeles,County,10257557,2805,3217485,23,33143,46666,72266489,3716,4073142
8/19/2022 0:00,Los Angeles,County,10257557,2497,3219982,14,33157,39308,72305797,3446,4076588
8/20/2022 0:00,Los Angeles,County,10257557,1829,3221811,19,33176,17142,72322939,2373,4078961
8/21/2022 0:00,Los Angeles,County,10257557,1591,3223402,13,33189,14346,72337285,1837,4080798
8/22/2022 0:00,Los Angeles,County,10257557,3264,3226666,16,33205,60539,72397824,4244,4085042
8/23/2022 0:00,Los Angeles,County,10257557,2941,3229607,11,33216,53069,72450893,3806,4088848
8/24/2022 0:00,Los Angeles,County,10257557,2669,3232276,19,33235,48357,72499250,3486,4092334
8/25/2022 0:00,Los Angeles,County,10257557,2364,3234640,11,33246,44646,72543896,3042,4095376
8/26/2022 0:00,Los Angeles,County,10257557,2161,3236801,15,33261,40004,72583900,2980,4098356
8/27/2022 0:00,Los Angeles,County,10257557,1413,3238214,9,33270,16228,72600128,1997,4100353
8/28/2022 0:00,Los Angeles,County,10257557,1328,3239542,14,33284,14378,72614506,1669,4102022
8/29/2022 0:00,Los Angeles,County,10257557,2703,3242245,8,33292,57137,72671643,3490,4105512
8/30/2022 0:00,Los Angeles,County,10257557,2238,3244483,9,33301,55543,72727186,2988,4108500
8/31/2022 0:00,Los Angeles,County,10257557,2098,3246581,15,33316,47896,72775082,2828,4111328
9/1/2022 0:00,Los Angeles,County,10257557,1824,3248405,12,33328,44071,72819153,2478,4113806
9/2/2022 0:00,Los Angeles,County,10257557,1587,3249992,14,33342,33853,72853006,2243,4116049
9/3/2022 0:00,Los Angeles,County,10257557,1058,3251050,16,33358,12357,72865363,1377,4117426
9/4/2022 0:00,Los Angeles,County,10257557,952,3252002,16,33374,12028,72877391,1182,4118608
9/5/2022 0:00,Los Angeles,County,10257557,951,3252953,16,33390,18541,72895932,1008,4119616
9/6/2022 0:00,Los Angeles,County,10257557,2433,3255386,13,33403,72871,72968803,3263,4122879
9/7/2022 0:00,Los Angeles,County,10257557,1789,3257175,14,33417,49444,73018247,2282,4125161
9/8/2022 0:00,Los Angeles,County,10257557,1607,3258782,12,33429,44468,73062715,2032,4127193
9/9/2022 0:00,Los Angeles,County,10257557,1467,3260249,17,33446,34919,73097634,1828,4129021
9/10/2022 0:00,Los Angeles,County,10257557,1043,3261292,10,33456,14834,73112468,1289,4130310
9/11/2022 0:00,Los Angeles,County,10257557,942,3262234,10,33466,12899,73125367,1028,4131338
9/12/2022 0:00,Los Angeles,County,10257557,1748,3263982,8,33474,55379,73180746,2209,4133547
9/13/2022 0:00,Los Angeles,County,10257557,1528,3265510,8,33482,51396,73232142,1989,4135536
9/14/2022 0:00,Los Angeles,County,10257557,1324,3266834,9,33491,44797,73276939,1750,4137286
9/15/2022 0:00,Los Angeles,County,10257557,1255,3268089,11,33502,44984,73321923,1649,4138935
9/16/2022 0:00,Los Angeles,County,10257557,1164,3269253,5,33507,34718,73356641,1540,4140475
9/17/2022 0:00,Los Angeles,County,10257557,899,3270152,10,33517,14099,73370740,1089,4141564
9/18/2022 0:00,Los Angeles,County,10257557,833,3270985,13,33530,12591,73383331,933,4142497
9/19/2022 0:00,Los Angeles,County,10257557,1550,3272535,10,33540,54291,73437622,1960,4144457
9/20/2022 0:00,Los Angeles,County,10257557,1383,3273918,5,33545,49951,73487573,1758,4146215
9/21/2022 0:00,Los Angeles,County,10257557,1163,3275081,11,33556,43837,73531410,1552,4147767
9/22/2022 0:00,Los Angeles,County,10257557,1168,3276249,10,33566,41861,73573271,1472,4149239
9/23/2022 0:00,Los Angeles,County,10257557,1044,3277293,5,33571,33269,73606540,1432,4150671
9/24/2022 0:00,Los Angeles,County,10257557,769,3278062,10,33581,12810,73619350,967,4151638
9/25/2022 0:00,Los Angeles,County,10257557,727,3278789,10,33591,10849,73630199,782,4152420
9/26/2022 0:00,Los Angeles,County,10257557,1468,3280257,12,33603,48790,73678989,1853,4154273
9/27/2022 0:00,Los Angeles,County,10257557,1189,3281446,11,33614,48763,73727752,1500,4155773
9/28/2022 0:00,Los Angeles,County,10257557,1199,3282645,4,33618,40831,73768583,1505,4157278
9/29/2022 0:00,Los Angeles,County,10257557,1121,3283766,9,33627,37194,73805777,1451,4158729
9/30/2022 0:00,Los Angeles,County,10257557,991,3284757,7,33634,30881,73836658,1363,4160092
10/1/2022 0:00,Los Angeles,County,10257557,745,3285502,5,33639,11250,73847908,884,4160976
10/2/2022 0:00,Los Angeles,County,10257557,627,3286129,8,33647,10659,73858567,732,4161708
10/3/2022 0:00,Los Angeles,County,10257557,1148,3287277,5,33652,42168,73900735,1503,4163211
10/4/2022 0:00,Los Angeles,County,10257557,1030,3288307,10,33662,39345,73940080,1284,4164495
10/5/2022 0:00,Los Angeles,County,10257557,897,3289204,11,33673,32279,73972359,1146,4165641
10/6/2022 0:00,Los Angeles,County,10257557,835,3290039,9,33682,31392,74003751,1130,4166771
10/7/2022 0:00,Los Angeles,County,10257557,846,3290885,9,33691,26453,74030204,1141,4167912
10/8/2022 0:00,Los Angeles,County,10257557,610,3291495,10,33701,11733,74041937,727,4168639
10/9/2022 0:00,Los Angeles,County,10257557,561,3292056,6,33707,10847,74052784,668,4169307
10/10/2022 0:00,Los Angeles,County,10257557,988,3293044,8,33715,38179,74090963,1169,4170476
10/11/2022 0:00,Los Angeles,County,10257557,876,3293920,7,33722,40431,74131394,1138,4171614
10/12/2022 0:00,Los Angeles,County,10257557,824,3294744,5,33727,34018,74165412,1056,4172670
10/13/2022 0:00,Los Angeles,County,10257557,751,3295495,10,33737,30247,74195659,955,4173625
10/14/2022 0:00,Los Angeles,County,10257557,734,3296229,9,33746,24729,74220388,894,4174519
10/15/2022 0:00,Los Angeles,County,10257557,504,3296733,5,33751,10521,74230909,620,4175139
10/16/2022 0:00,Los Angeles,County,10257557,478,3297211,2,33753,10639,74241548,543,4175682
10/17/2022 0:00,Los Angeles,County,10257557,921,3298132,4,33757,39122,74280670,1125,4176807
10/18/2022 0:00,Los Angeles,County,10257557,897,3299029,7,33764,36482,74317152,1063,4177870
10/19/2022 0:00,Los Angeles,County,10257557,810,3299839,5,33769,33522,74350674,1006,4178876
10/20/2022 0:00,Los Angeles,County,10257557,828,3300667,8,33777,28775,74379449,1001,4179877
10/21/2022 0:00,Los Angeles,County,10257557,749,3301416,11,33788,26637,74406086,959,4180836
10/22/2022 0:00,Los Angeles,County,10257557,564,3301980,7,33795,11116,74417202,679,4181515
10/23/2022 0:00,Los Angeles,County,10257557,522,3302502,9,33804,10275,74427477,569,4182084
10/24/2022 0:00,Los Angeles,County,10257557,966,3303468,7,33811,40522,74467999,1188,4183272
10/25/2022 0:00,Los Angeles,County,10257557,1002,3304470,10,33821,38941,74506940,1212,4184484
10/26/2022 0:00,Los Angeles,County,10257557,893,3305363,1,33822,33882,74540822,1087,4185571
10/27/2022 0:00,Los Angeles,County,10257557,928,3306291,8,33830,28848,74569670,1127,4186698
10/28/2022 0:00,Los Angeles,County,10257557,868,3307159,9,33839,26235,74595905,1037,4187735
10/29/2022 0:00,Los Angeles,County,10257557,637,3307796,2,33841,12229,74608134,728,4188463
10/30/2022 0:00,Los Angeles,County,10257557,633,3308429,2,33843,11997,74620131,669,4189132
10/31/2022 0:00,Los Angeles,County,10257557,1267,3309696,6,33849,40442,74660573,1541,4190673
11/1/2022 0:00,Los Angeles,County,10257557,1237,3310933,6,33855,37775,74698348,1424,4192097
11/2/2022 0:00,Los Angeles,County,10257557,1244,3312177,7,33862,34011,74732359,1434,4193531
11/3/2022 0:00,Los Angeles,County,10257557,1208,3313385,9,33871,29016,74761375,1429,4194960
11/4/2022 0:00,Los Angeles,County,10257557,1095,3314480,13,33884,26322,74787697,1298,4196258
11/5/2022 0:00,Los Angeles,County,10257557,826,3315306,5,33889,12606,74800303,923,4197181
11/6/2022 0:00,Los Angeles,County,10257557,861,3316167,8,33897,11950,74812253,862,4198043
11/7/2022 0:00,Los Angeles,County,10257557,1643,3317810,7,33904,40776,74853029,1946,4199989
11/8/2022 0:00,Los Angeles,County,10257557,1373,3319183,5,33909,35952,74888981,1606,4201595
11/9/2022 0:00,Los Angeles,County,10257557,1429,3320612,9,33918,35678,74924659,1712,4203307
11/10/2022 0:00,Los Angeles,County,10257557,1469,3322081,6,33924,31412,74956071,1770,4205077
11/11/2022 0:00,Los Angeles,County,10257557,1274,3323355,8,33932,24381,74980452,1507,4206584
11/12/2022 0:00,Los Angeles,County,10257557,951,3324306,3,33935,13035,74993487,1201,4207785
11/13/2022 0:00,Los Angeles,County,10257557,979,3325285,7,33942,12663,75006150,1126,4208911
11/14/2022 0:00,Los Angeles,County,10257557,1959,3327244,11,33953,44296,75050446,2342,4211253
11/15/2022 0:00,Los Angeles,County,10257557,1778,3329022,12,33965,39919,75090365,2235,4213488
11/16/2022 0:00,Los Angeles,County,10257557,1885,3330907,14,33979,36483,75126848,2197,4215685
11/17/2022 0:00,Los Angeles,County,10257557,1823,3332730,8,33987,30977,75157825,2145,4217830
11/18/2022 0:00,Los Angeles,County,10257557,1945,3334675,8,33995,27497,75185322,2300,4220130
11/19/2022 0:00,Los Angeles,County,10257557,1402,3336077,11,34006,13495,75198817,1498,4221628
11/20/2022 0:00,Los Angeles,County,10257557,1512,3337589,7,34013,13060,75211877,1477,4223105
11/21/2022 0:00,Los Angeles,County,10257557,2893,3340482,9,34022,39181,75251058,3285,4226390
11/22/2022 0:00,Los Angeles,County,10257557,2622,3343104,10,34032,33189,75284247,3095,4229485
11/23/2022 0:00,Los Angeles,County,10257557,2706,3345810,14,34046,29919,75314166,3070,4232555
11/24/2022 0:00,Los Angeles,County,10257557,1059,3346869,9,34055,7455,75321621,815,4233370
11/25/2022 0:00,Los Angeles,County,10257557,2609,3349478,12,34067,20891,75342512,2899,4236269
11/26/2022 0:00,Los Angeles,County,10257557,2325,3351803,9,34076,16541,75359053,2440,4238709
11/27/2022 0:00,Los Angeles,County,10257557,2509,3354312,20,34096,16400,75375453,2262,4240971
11/28/2022 0:00,Los Angeles,County,10257557,5145,3359457,16,34112,60839,75436292,5984,4246955
11/29/2022 0:00,Los Angeles,County,10257557,4332,3363789,15,34127,49271,75485563,5088,4252043
11/30/2022 0:00,Los Angeles,County,10257557,3976,3367765,15,34142,42914,75528477,4744,4256787
12/1/2022 0:00,Los Angeles,County,10257557,3480,3371245,8,34150,37673,75566150,4153,4260940
12/2/2022 0:00,Los Angeles,County,10257557,2892,3374137,16,34166,32279,75598429,3577,4264517
12/3/2022 0:00,Los Angeles,County,10257557,2057,3376194,16,34182,15498,75613927,2462,4266979
12/4/2022 0:00,Los Angeles,County,10257557,1900,3378094,16,34198,14853,75628780,2226,4269205
12/5/2022 0:00,Los Angeles,County,10257557,3852,3381946,24,34222,53008,75681788,4800,4274005
12/6/2022 0:00,Los Angeles,County,10257557,3118,3385064,20,34242,43687,75725475,3847,4277852
12/7/2022 0:00,Los Angeles,County,10257557,2878,3387942,20,34262,40055,75765530,3594,4281446
12/8/2022 0:00,Los Angeles,County,10257557,2692,3390634,22,34284,35741,75801271,3368,4284814
12/9/2022 0:00,Los Angeles,County,10257557,2518,3393152,17,34301,29335,75830606,3131,4287945
12/10/2022 0:00,Los Angeles,County,10257557,1717,3394869,29,34330,15145,75845751,2035,4289980
12/11/2022 0:00,Los Angeles,County,10257557,1465,3396334,25,34355,13957,75859708,1747,4291727
12/12/2022 0:00,Los Angeles,County,10257557,3229,3399563,25,34380,50961,75910669,3938,4295665
12/13/2022 0:00,Los Angeles,County,10257557,2801,3402364,21,34401,44843,75955512,3506,4299171
12/14/2022 0:00,Los Angeles,County,10257557,2572,3404936,23,34424,36758,75992270,3249,4302420
12/15/2022 0:00,Los Angeles,County,10257557,2379,3407315,11,34435,32871,76025141,2911,4305331
12/16/2022 0:00,Los Angeles,County,10257557,2031,3409346,21,34456,29174,76054315,2570,4307901
12/17/2022 0:00,Los Angeles,County,10257557,1469,3410815,18,34474,12800,76067115,1705,4309606
12/18/2022 0:00,Los Angeles,County,10257557,1307,3412122,22,34496,13114,76080229,1475,4311081
12/19/2022 0:00,Los Angeles,County,10257557,2804,3414926,14,34510,39424,76119653,3415,4314496
12/20/2022 0:00,Los Angeles,County,10257557,2620,3417546,20,34530,34938,76154591,3106,4317602
12/21/2022 0:00,Los Angeles,County,10257557,2377,3419923,25,34555,26207,76180798,2918,4320520
12/22/2022 0:00,Los Angeles,County,10257557,2240,3422163,25,34580,25076,76205874,2629,4323149
12/23/2022 0:00,Los Angeles,County,10257557,2032,3424195,30,34610,20262,76226136,2548,4325697
12/24/2022 0:00,Los Angeles,County,10257557,1192,3425387,20,34630,7703,76233839,1240,4326937
12/25/2022 0:00,Los Angeles,County,10257557,765,3426152,25,34655,5766,76239605,621,4327558
12/26/2022 0:00,Los Angeles,County,10257557,2326,3428478,25,34680,20988,76260593,2744,4330302
12/27/2022 0:00,Los Angeles,County,10257557,2842,3431320,28,34708,34960,76295553,3459,4333761
12/28/2022 0:00,Los Angeles,County,10257557,2572,3433892,18,34726,23217,76318770,3185,4336946
12/29/2022 0:00,Los Angeles,County,10257557,2208,3436100,18,34744,24104,76342874,2695,4339641
12/30/2022 0:00,Los Angeles,County,10257557,1988,3438088,31,34775,21041,76363915,2541,4342182
12/31/2022 0:00,Los Angeles,County,10257557,1131,3439219,15,34790,8664,76372579,1324,4343506
1/1/2023 0:00,Los Angeles,County,10257557,847,3440066,17,34807,6338,76378917,696,4344202
1/2/2023 0:00,Los Angeles,County,10257557,1862,3441928,19,34826,25921,76404838,2435,4346637
1/3/2023 0:00,Los Angeles,County,10257557,2202,3444130,23,34849,42464,76447302,2816,4349453
1/4/2023 0:00,Los Angeles,County,10257557,1762,3445892,15,34864,32356,76479658,2288,4351741
1/5/2023 0:00,Los Angeles,County,10257557,1525,3447417,29,34893,27522,76507180,1887,4353628
1/6/2023 0:00,Los Angeles,County,10257557,1459,3448876,24,34917,28040,76535220,1891,4355519
1/7/2023 0:00,Los Angeles,County,10257557,992,3449868,17,34934,15054,76550274,1273,4356792
1/8/2023 0:00,Los Angeles,County,10257557,867,3450735,14,34948,13342,76563616,1058,4357850
1/9/2023 0:00,Los Angeles,County,10257557,1400,3452135,18,34966,40259,76603875,1850,4359700
1/10/2023 0:00,Los Angeles,County,10257557,1093,3453228,21,34987,33817,76637692,1452,4361152
1/11/2023 0:00,Los Angeles,County,10257557,1188,3454416,19,35006,30719,76668411,1526,4362678
1/12/2023 0:00,Los Angeles,County,10257557,1000,3455416,23,35029,28133,76696544,1320,4363998
1/13/2023 0:00,Los Angeles,County,10257557,900,3456316,26,35055,23424,76719968,1163,4365161
1/14/2023 0:00,Los Angeles,County,10257557,574,3456890,16,35071,10144,76730112,712,4365873
1/15/2023 0:00,Los Angeles,County,10257557,593,3457483,19,35090,9274,76739386,671,4366544
1/16/2023 0:00,Los Angeles,County,10257557,790,3458273,21,35111,23227,76762613,976,4367520
1/17/2023 0:00,Los Angeles,County,10257557,1102,3459375,17,35128,42327,76804940,1358,4368878
1/18/2023 0:00,Los Angeles,County,10257557,884,3460259,19,35147,31381,76836321,1131,4370009
1/19/2023 0:00,Los Angeles,County,10257557,821,3461080,18,35165,27688,76864009,1031,4371040
1/20/2023 0:00,Los Angeles,County,10257557,795,3461875,21,35186,24109,76888118,982,4372022
1/21/2023 0:00,Los Angeles,County,10257557,515,3462390,14,35200,10295,76898413,662,4372684
1/22/2023 0:00,Los Angeles,County,10257557,560,3462950,10,35210,9333,76907746,598,4373282
1/23/2023 0:00,Los Angeles,County,10257557,986,3463936,11,35221,34308,76942054,1179,4374461
1/24/2023 0:00,Los Angeles,County,10257557,977,3464913,19,35240,32997,76975051,1157,4375618
1/25/2023 0:00,Los Angeles,County,10257557,877,3465790,20,35260,29208,77004259,1111,4376729
1/26/2023 0:00,Los Angeles,County,10257557,776,3466566,17,35277,23729,77027988,955,4377684
1/27/2023 0:00,Los Angeles,County,10257557,852,3467418,16,35293,21505,77049493,1013,4378697
1/28/2023 0:00,Los Angeles,County,10257557,588,3468006,14,35307,9866,77059359,695,4379392
1/29/2023 0:00,Los Angeles,County,10257557,612,3468618,11,35318,9402,77068761,636,4380028
1/30/2023 0:00,Los Angeles,County,10257557,1167,3469785,12,35330,33483,77102244,1437,4381465
1/31/2023 0:00,Los Angeles,County,10257557,1065,3470850,15,35345,30123,77132367,1287,4382752
2/1/2023 0:00,Los Angeles,County,10257557,921,3471771,14,35359,27229,77159596,1083,4383835
2/2/2023 0:00,Los Angeles,County,10257557,867,3472638,14,35373,24623,77184219,1059,4384894
2/3/2023 0:00,Los Angeles,County,10257557,802,3473440,11,35384,20894,77205113,960,4385854
2/4/2023 0:00,Los Angeles,County,10257557,585,3474025,11,35395,9582,77214695,708,4386562
2/5/2023 0:00,Los Angeles,County,10257557,633,3474658,13,35408,9069,77223764,695,4387257
2/6/2023 0:00,Los Angeles,County,10257557,1177,3475835,13,35421,31102,77254866,1428,4388685
2/7/2023 0:00,Los Angeles,County,10257557,965,3476800,10,35431,26847,77281713,1212,4389897
2/8/2023 0:00,Los Angeles,County,10257557,996,3477796,16,35447,24766,77306479,1167,4391064
2/9/2023 0:00,Los Angeles,County,10257557,870,3478666,12,35459,22692,77329171,1076,4392140
2/10/2023 0:00,Los Angeles,County,10257557,828,3479494,13,35472,20801,77349972,1028,4393168
2/11/2023 0:00,Los Angeles,County,10257557,653,3480147,7,35479,9182,77359154,752,4393920
2/12/2023 0:00,Los Angeles,County,10257557,638,3480785,8,35487,8912,77368066,692,4394612
2/13/2023 0:00,Los Angeles,County,10257557,1083,3481868,12,35499,29338,77397404,1330,4395942
2/14/2023 0:00,Los Angeles,County,10257557,946,3482814,15,35514,26244,77423648,1161,4397103
2/15/2023 0:00,Los Angeles,County,10257557,945,3483759,9,35523,23869,77447517,1181,4398284
2/16/2023 0:00,Los Angeles,County,10257557,889,3484648,13,35536,21531,77469048,1109,4399393
2/17/2023 0:00,Los Angeles,County,10257557,813,3485461,6,35542,19754,77488802,996,4400389
2/18/2023 0:00,Los Angeles,County,10257557,581,3486042,15,35557,9112,77497914,677,4401066
2/19/2023 0:00,Los Angeles,County,10257557,566,3486608,13,35570,7859,77505773,653,4401719
2/20/2023 0:00,Los Angeles,County,10257557,958,3487566,11,35581,20356,77526129,1145,4402864
2/21/2023 0:00,Los Angeles,County,10257557,1110,3488676,7,35588,30224,77556353,1379,4404243
2/22/2023 0:00,Los Angeles,County,10257557,928,3489604,8,35596,24487,77580840,1186,4405429
2/23/2023 0:00,Los Angeles,County,10257557,864,3490468,13,35609,23655,77604495,1088,4406517
2/24/2023 0:00,Los Angeles,County,10257557,660,3491128,10,35619,18215,77622710,797,4407314
2/25/2023 0:00,Los Angeles,County,10257557,450,3491578,8,35627,8296,77631006,548,4407862
2/26/2023 0:00,Los Angeles,County,10257557,488,3492066,15,35642,7524,77638530,522,4408384
2/27/2023 0:00,Los Angeles,County,10257557,905,3492971,12,35654,25915,77664445,1129,4409513
2/28/2023 0:00,Los Angeles,County,10257557,891,3493862,14,35668,23740,77688185,1103,4410616
3/1/2023 0:00,Los Angeles,County,10257557,710,3494572,9,35677,21646,77709831,901,4411517
3/2/2023 0:00,Los Angeles,County,10257557,797,3495369,16,35693,21632,77731463,940,4412457
3/3/2023 0:00,Los Angeles,County,10257557,608,3495977,9,35702,17635,77749098,782,4413239
3/4/2023 0:00,Los Angeles,County,10257557,471,3496448,12,35714,9543,77758641,551,4413790
3/5/2023 0:00,Los Angeles,County,10257557,403,3496851,4,35718,7457,77766098,484,4414274
3/6/2023 0:00,Los Angeles,County,10257557,801,3497652,4,35722,26042,77792140,1001,4415275
3/7/2023 0:00,Los Angeles,County,10257557,662,3498314,7,35729,24770,77816910,852,4416127
3/8/2023 0:00,Los Angeles,County,10257557,735,3499049,14,35743,21935,77838845,900,4417027
3/9/2023 0:00,Los Angeles,County,10257557,662,3499711,11,35754,21440,77860285,853,4417880
3/10/2023 0:00,Los Angeles,County,10257557,562,3500273,11,35765,17346,77877631,765,4418645
3/11/2023 0:00,Los Angeles,County,10257557,413,3500686,6,35771,10119,77887750,473,4419118
3/12/2023 0:00,Los Angeles,County,10257557,344,3501030,7,35778,7580,77895330,383,4419501
3/13/2023 0:00,Los Angeles,County,10257557,742,3501772,16,35794,26604,77921934,922,4420423
3/14/2023 0:00,Los Angeles,County,10257557,502,3502274,10,35804,22155,77944089,654,4421077
3/15/2023 0:00,Los Angeles,County,10257557,518,3502792,8,35812,20380,77964469,646,4421723
3/16/2023 0:00,Los Angeles,County,10257557,613,3503405,11,35823,20001,77984470,757,4422480
3/17/2023 0:00,Los Angeles,County,10257557,488,3503893,11,35834,15943,78000413,602,4423082
3/18/2023 0:00,Los Angeles,County,10257557,344,3504237,8,35842,8368,78008781,399,4423481
3/19/2023 0:00,Los Angeles,County,10257557,239,3504476,7,35849,6552,78015333,328,4423809
3/20/2023 0:00,Los Angeles,County,10257557,525,3505001,5,35854,23148,78038481,630,4424439
3/21/2023 0:00,Los Angeles,County,10257557,455,3505456,4,35858,18791,78057272,521,4424960
3/22/2023 0:00,Los Angeles,County,10257557,377,3505833,5,35863,18310,78075582,471,4425431
3/23/2023 0:00,Los Angeles,County,10257557,402,3506235,3,35866,19560,78095142,506,4425937
3/24/2023 0:00,Los Angeles,County,10257557,353,3506588,3,35869,16398,78111540,439,4426376
3/25/2023 0:00,Los Angeles,County,10257557,216,3506804,7,35876,7684,78119224,291,4426667
3/26/2023 0:00,Los Angeles,County,10257557,244,3507048,8,35884,6036,78125260,301,4426968
3/27/2023 0:00,Los Angeles,County,10257557,395,3507443,3,35887,20476,78145736,453,4427421
3/28/2023 0:00,Los Angeles,County,10257557,459,3507902,4,35891,19295,78165031,525,4427946
3/29/2023 0:00,Los Angeles,County,10257557,427,3508329,6,35897,17270,78182301,507,4428453
3/30/2023 0:00,Los Angeles,County,10257557,380,3508709,5,35902,17555,78199856,468,4428921
3/31/2023 0:00,Los Angeles,County,10257557,327,3509036,6,35908,14341,78214197,392,4429313
4/1/2023 0:00,Los Angeles,County,10257557,259,3509295,6,35914,6713,78220910,294,4429607
4/2/2023 0:00,Los Angeles,County,10257557,206,3509501,8,35922,5854,78226764,253,4429860
4/3/2023 0:00,Los Angeles,County,10257557,422,3509923,7,35929,18601,78245365,487,4430347
4/4/2023 0:00,Los Angeles,County,10257557,369,3510292,7,35936,16280,78261645,417,4430764
4/5/2023 0:00,Los Angeles,County,10257557,355,3510647,6,35942,14665,78276310,419,4431183
4/6/2023 0:00,Los Angeles,County,10257557,357,3511004,7,35949,13767,78290077,427,4431610
4/7/2023 0:00,Los Angeles,County,10257557,344,3511348,5,35954,11800,78301877,391,4432001
4/8/2023 0:00,Los Angeles,County,10257557,268,3511616,5,35959,7766,78309643,304,4432305
4/9/2023 0:00,Los Angeles,County,10257557,182,3511798,7,35966,5518,78315161,199,4432504
4/10/2023 0:00,Los Angeles,County,10257557,570,3512368,6,35972,20906,78336067,636,4433140
4/11/2023 0:00,Los Angeles,County,10257557,396,3512764,5,35977,18343,78354410,467,4433607
4/12/2023 0:00,Los Angeles,County,10257557,378,3513142,5,35982,17671,78372081,418,4434025
4/13/2023 0:00,Los Angeles,County,10257557,373,3513515,5,35987,15429,78387510,447,4434472
4/14/2023 0:00,Los Angeles,County,10257557,295,3513810,7,35994,12742,78400252,349,4434821
4/15/2023 0:00,Los Angeles,County,10257557,217,3514027,5,35999,7473,78407725,252,4435073
4/16/2023 0:00,Los Angeles,County,10257557,189,3514216,11,36010,5760,78413485,236,4435309
4/17/2023 0:00,Los Angeles,County,10257557,369,3514585,3,36013,18953,78432438,412,4435721
4/18/2023 0:00,Los Angeles,County,10257557,338,3514923,6,36019,19206,78451644,393,4436114
4/19/2023 0:00,Los Angeles,County,10257557,277,3515200,8,36027,14937,78466581,329,4436443
4/20/2023 0:00,Los Angeles,County,10257557,311,3515511,2,36029,15443,78482024,361,4436804
4/21/2023 0:00,Los Angeles,County,10257557,260,3515771,3,36032,12845,78494869,317,4437121
4/22/2023 0:00,Los Angeles,County,10257557,195,3515966,8,36040,8128,78502997,241,4437362
4/23/2023 0:00,Los Angeles,County,10257557,189,3516155,2,36042,5251,78508248,199,4437561
4/24/2023 0:00,Los Angeles,County,10257557,363,3516518,4,36046,18282,78526530,402,4437963
4/25/2023 0:00,Los Angeles,County,10257557,330,3516848,8,36054,17489,78544019,383,4438346
4/26/2023 0:00,Los Angeles,County,10257557,336,3517184,5,36059,16622,78560641,388,4438734
4/27/2023 0:00,Los Angeles,County,10257557,301,3517485,9,36068,14487,78575128,336,4439070
4/28/2023 0:00,Los Angeles,County,10257557,244,3517729,3,36071,12756,78587884,307,4439377
4/29/2023 0:00,Los Angeles,County,10257557,188,3517917,4,36075,7310,78595194,228,4439605
4/30/2023 0:00,Los Angeles,County,10257557,161,3518078,6,36081,6014,78601208,197,4439802
5/1/2023 0:00,Los Angeles,County,10257557,363,3518441,2,36083,17381,78618589,427,4440229
5/2/2023 0:00,Los Angeles,County,10257557,343,3518784,2,36085,16645,78635234,398,4440627
5/3/2023 0:00,Los Angeles,County,10257557,259,3519043,6,36091,14307,78649541,303,4440930
5/4/2023 0:00,Los Angeles,County,10257557,270,3519313,3,36094,12792,78662333,313,4441243
5/5/2023 0:00,Los Angeles,County,10257557,279,3519592,6,36100,10503,78672836,301,4441544
5/6/2023 0:00,Los Angeles,County,10257557,166,3519758,5,36105,5097,78677933,190,4441734
5/7/2023 0:00,Los Angeles,County,10257557,193,3519951,5,36110,5065,78682998,221,4441955
5/8/2023 0:00,Los Angeles,County,10257557,355,3520306,7,36117,14765,78697763,411,4442366
5/9/2023 0:00,Los Angeles,County,10257557,328,3520634,2,36119,16267,78714030,378,4442744
5/10/2023 0:00,Los Angeles,County,10257557,317,3520951,3,36122,15523,78729553,369,4443113
5/11/2023 0:00,Los Angeles,County,10257557,317,3521268,6,36128,13811,78743364,351,4443464
5/12/2023 0:00,Los Angeles,County,10257557,227,3521495,6,36134,8608,78751972,282,4443746
5/13/2023 0:00,Los Angeles,County,10257557,135,3521630,7,36141,4460,78756432,177,4443923
5/14/2023 0:00,Los Angeles,County,10257557,123,3521753,4,36145,4239,78760671,141,4444064
5/15/2023 0:00,Los Angeles,County,10257557,309,3522062,3,36148,12599,78773270,359,4444423
5/16/2023 0:00,Los Angeles,County,10257557,278,3522340,5,36153,12078,78785348,328,4444751
5/17/2023 0:00,Los Angeles,County,10257557,256,3522596,1,36154,10591,78795939,294,4445045
5/18/2023 0:00,Los Angeles,County,10257557,235,3522831,3,36157,9797,78805736,277,4445322
5/19/2023 0:00,Los Angeles,County,10257557,189,3523020,3,36160,6650,78812386,227,4445549
5/20/2023 0:00,Los Angeles,County,10257557,162,3523182,4,36164,4356,78816742,174,4445723
5/21/2023 0:00,Los Angeles,County,10257557,126,3523308,8,36172,3975,78820717,148,4445871
5/22/2023 0:00,Los Angeles,County,10257557,205,3523513,6,36178,10078,78830795,237,4446108
5/23/2023 0:00,Los Angeles,County,10257557,278,3523791,3,36181,10755,78841550,300,4446408
5/24/2023 0:00,Los Angeles,County,10257557,218,3524009,6,36187,9680,78851230,263,4446671
5/25/2023 0:00,Los Angeles,County,10257557,225,3524234,2,36189,8710,78859940,257,4446928
5/26/2023 0:00,Los Angeles,County,10257557,188,3524422,5,36194,6289,78866229,234,4447162
5/27/2023 0:00,Los Angeles,County,10257557,136,3524558,9,36203,3969,78870198,158,4447320
5/28/2023 0:00,Los Angeles,County,10257557,123,3524681,7,36210,3611,78873809,141,4447461
5/29/2023 0:00,Los Angeles,County,10257557,126,3524807,7,36217,5620,78879429,143,4447604
5/30/2023 0:00,Los Angeles,County,10257557,290,3525097,4,36221,9735,78889164,335,4447939
5/31/2023 0:00,Los Angeles,County,10257557,228,3525325,5,36226,8875,78898039,271,4448210
6/1/2023 0:00,Los Angeles,County,10257557,202,3525527,3,36229,7508,78905547,222,4448432
6/2/2023 0:00,Los Angeles,County,10257557,187,3525714,3,36232,6201,78911748,201,4448633
6/3/2023 0:00,Los Angeles,County,10257557,134,3525848,3,36235,3321,78915069,139,4448772
6/4/2023 0:00,Los Angeles,County,10257557,120,3525968,0,36235,3004,78918073,140,4448912
6/5/2023 0:00,Los Angeles,County,10257557,247,3526215,4,36239,8071,78926144,282,4449194
6/6/2023 0:00,Los Angeles,County,10257557,252,3526467,0,36239,7267,78933411,298,4449492
6/7/2023 0:00,Los Angeles,County,10257557,218,3526685,3,36242,6870,78940281,238,4449730
6/8/2023 0:00,Los Angeles,County,10257557,199,3526884,3,36245,5887,78946168,230,4449960
6/9/2023 0:00,Los Angeles,County,10257557,192,3527076,3,36248,5848,78952016,196,4450156
6/10/2023 0:00,Los Angeles,County,10257557,105,3527181,1,36249,2672,78954688,117,4450273
6/11/2023 0:00,Los Angeles,County,10257557,104,3527285,5,36254,1921,78956609,112,4450385
6/12/2023 0:00,Los Angeles,County,10257557,243,3527528,1,36255,6356,78962965,240,4450625
6/13/2023 0:00,Los Angeles,County,10257557,258,3527786,5,36260,6428,78969393,286,4450911
6/14/2023 0:00,Los Angeles,County,10257557,235,3528021,3,36263,6094,78975487,268,4451179
6/15/2023 0:00,Los Angeles,County,10257557,194,3528215,4,36267,5773,78981260,208,4451387
6/16/2023 0:00,Los Angeles,County,10257557,195,3528410,1,36268,5655,78986915,219,4451606
6/17/2023 0:00,Los Angeles,County,10257557,142,3528552,6,36274,3551,78990466,157,4451763
6/18/2023 0:00,Los Angeles,County,10257557,125,3528677,2,36276,2400,78992866,141,4451904
6/19/2023 0:00,Los Angeles,County,10257557,244,3528921,3,36279,5756,78998622,265,4452169
6/20/2023 0:00,Los Angeles,County,10257557,239,3529160,2,36281,7638,79006260,265,4452434
6/21/2023 0:00,Los Angeles,County,10257557,220,3529380,2,36283,5969,79012229,247,4452681
6/22/2023 0:00,Los Angeles,County,10257557,235,3529615,2,36285,5454,79017683,254,4452935
6/23/2023 0:00,Los Angeles,County,10257557,201,3529816,2,36287,5171,79022854,232,4453167
6/24/2023 0:00,Los Angeles,County,10257557,133,3529949,2,36289,3366,79026220,155,4453322
6/25/2023 0:00,Los Angeles,County,10257557,107,3530056,2,36291,2567,79028787,118,4453440
6/26/2023 0:00,Los Angeles,County,10257557,229,3530285,2,36293,5825,79034612,262,4453702
6/27/2023 0:00,Los Angeles,County,10257557,205,3530490,1,36294,5967,79040579,244,4453946
6/28/2023 0:00,Los Angeles,County,10257557,213,3530703,4,36298,4603,79045182,235,4454181
6/29/2023 0:00,Los Angeles,County,10257557,223,3530926,1,36299,5037,79050219,240,4454421
6/30/2023 0:00,Los Angeles,County,10257557,175,3531101,1,36300,3593,79053812,198,4454619
7/1/2023 0:00,Los Angeles,County,10257557,155,3531256,0,36300,2030,79055842,156,4454775
7/2/2023 0:00,Los Angeles,County,10257557,92,3531348,0,36300,1499,79057341,82,4454857
7/3/2023 0:00,Los Angeles,County,10257557,175,3531523,0,36300,611,79057952,27,4454884
7/4/2023 0:00,Los Angeles,County,10257557,101,3531624,0,36300,499,79058451,14,4454898
7/5/2023 0:00,Los Angeles,County,10257557,189,3531813,1,36301,245,79058696,25,4454923
7/6/2023 0:00,Los Angeles,County,10257557,146,3531959,0,36301,307,79059003,29,4454952
7/7/2023 0:00,Los Angeles,County,10257557,144,3532103,0,36301,499,79059502,17,4454969
7/8/2023 0:00,Los Angeles,County,10257557,94,3532197,0,36301,187,79059689,11,4454980
7/9/2023 0:00,Los Angeles,County,10257557,94,3532291,0,36301,138,79059827,12,4454992
7/10/2023 0:00,Los Angeles,County,10257557,27,3532318,0,36301,105,79059932,6,4454998
7/11/2023 0:00,Los Angeles,County,10257557,0,3532318,0,36301,,79059932,,4454998
,Los Angeles,County,10257557,263,3532581,4,36305,45668,79105600,2455,4457453
